前	后
后	先,前
冷	暖,热
热	凉,冷
高	洼,低,矮
矮	高
进	退
退	定,进
死	生,活
活	呆,板,死
快	迟,慢,钝
慢	快,急
轻	重
重	轻
缓	速,急
急	缓,慢
宽	窄,严
窄	广,宽
强	弱
弱	强
松	紧
紧	松
好	恶,赖,坏,歹,糟
坏	好
美	丑
丑	美,俊
善	恶
恶	好,善
是	非,否
非	是
闲	忙
忙	闲
来	往,去
去	回,留,来,归,还
分	聚,合
合	分,离
存	亡,取
亡	昌,存
动	静
静	动
浓	淡
淡	浓,咸
偏	正,全
正	反,误,歪,枉,倒,斜,邪,偏,侧,副
饥	饱
饱	饿,饥,瘪
爱	恨,憎
恨	爱
升	降
降	涨,升
开	封,盖,关闭,谢,关掉,关,关上,闭
关	开,打开
始	终
终	始
胖	瘦
瘦	胖,肥
迎	逐,送
送	收,夺,迎
盈	亏
亏	余,足,盈,够
真	伪,假
假	真
虚	实
实	虚,名,空
有	没,无
无	有
雅	俗
俗	雅,僧
否	是
稀	密,稠
密	稀,疏
粗	细,精
细	粗
东	西
西	东,中
巧	拙
拙	巧
恩	仇,怨
怨	恩
新	故,陈,旧
旧	新
邪	正
通	住宿,堵
堵	通
止	起,行
行	止
古	今
今	昔,古
张	弛
弛	张
曲	直
直	弯,屈,曲
亮	暗,黑
暗	明,亮
亲	干,疏
疏	亲,密
输	赢
赢	输
逆	顺
顺	逆
苦	甜,甘
甜	苦
忠	奸
奸	忠
纵	横
横	竖,纵
得	失
失	得
南	北
北	南
薄	厚
厚	薄
哭	笑
笑	哭,啼
文	武,白
武	文
推	拉,提
拉	推
问	答
答	问
主	次,支2,仆,客,宾,从,奴
仆	主
买	卖
卖	买
深	浅
浅	深
聚	散,分
散	聚
干	群,亲,潮,枝,湿,鲜
湿	干
彼	此,己
此	彼
生	师,卒,死,熟
熟	生,生2
单	复,双
双	单
首	末,尾
末	首,初,本
敌	我,友
友	仇,敌
警	匪
匪	警
大	小
小	大,巨
盛	衰
衰	盛,兴
胜	败,负
败	胜,成
加	减,减小
减	添,加,增
软	硬
硬	软
阴	晴,阳
阳	阴
反	正
祸	福
福	祸
信	疑
疑	信
错	对
对	错,差
藏	露
露	含,匿,遮,藏
老	少,嫩
少	老,多
断	续,连
续	断
钝	快,利,锐
锐	钝
雌	雄
雄	雌
醒	醉,睡,晕
睡	醒
起	伏,讫,止
咸	淡
歪	正
左	右
右	左
尊	卑
卑	尊
公	私,母
私	公
矛	盾
盾	矛
宽阔	狭窄,狭小
狭窄	广泛,宽敞,辽阔,广阔,宽阔,宽广,宽绰
平静	动荡,沸腾,激荡,激烈,惊诧,静卧,颤动,激动,热烈
动荡	稳定,安定,平静,安稳
加重	减轻
减轻	加重,加剧
缓慢	怠缓,宽和,连忙,立刻,赶快,飞快,急速,赶紧,迅速,飞速,火速,麻利,急剧,舒缓,迂缓,快速,紧急,急促,飞驰
快速	缓慢
节省	浪费,a节省节约a,耗费
浪费	俭省,节省,糟踏,撙节,节约,吝惜,节流
分散	聚拢,联合,攒聚,聚集,积聚,凑拢,结集,汇集,集中
聚拢	散开,分散
茂盛	凋落,残败,凋零,零落,枯萎
枯萎	茂密,繁盛,葱茏,茂盛,成长,芜秽,茁壮,丰美
美丽	丑陋
丑陋	俊俏,美观,娟秀,优美,漂亮,俏丽,美丽,秀丽,英俊,标致
静寂	喧闹,热闹
热闹	冷清,寂寥,寂寞,宁静,安静,静寂,偏僻,冷落,背静,沉静,安谧,静谧,孤寂,冷僻,孤独
清楚	朦胧,隐约,模糊,含糊
模糊	醒目,隐晦,朦胧,清楚,清晰,昏花,暗晦,分明,显明,明晰
镇静	惊慌,发慌,慌乱,着急,兴奋
慌乱	镇静,镇定
伸开	缩拢
缩拢	伸开
威武	沮丧
沮丧	兴奋,威武
巨大	细小,微小,窄小
细小	洪大,幼细,庞大,巨大
神秘	平常
平常	神奇,希罕,非常,古怪,出奇,离奇,了得,异常,神秘,奇特
寒冷	温暖,炎热,暖和,火热
炎热	凛冽,阴凉,燠热,严寒,寒冷
原始	现代
现代	原始,摩登,传统,古代,古老
珍贵	普通
普通	神奇,特殊,典型,特别,特出,珍贵,别致
舒服	难受
难受	舒适,开心,好过,高兴,舒服,痛快,难熬
弯曲	挺拔,挺立,挺直,伸直,笔直
笔直	平直,曲折,弯曲,蜿蜒
均匀	悬殊,散乱
悬殊	均匀,相当
牢固	松散,不结实,脆弱
脆弱	坚固,顽强,牢固,坚韧,坚强
新鲜	腐烂,腐败,陈旧,陈腐
陈腐	新奇,新鲜,清新
反面	正面,侧面
正面	背面,反面,侧面,背后,负面
丰年	歉岁,荒年,歉年
歉年	丰年
干燥	滋润,潮湿,湿润
潮湿	干燥
平坦	低洼,陡峭,险阻,崎岖,陡峻,高峻,陡立
崎岖	平坦,坦平
简单	烦冗,复杂,复合,详细
复杂	单纯,简单,繁复,单一,驳杂
粗糙	平滑,工细,精致,滑腻,细腻,光润,精细,光滑,细嫩
细腻	粗糙
幸福	苦难,悲惨,痛苦,可怜,困苦,灾难
悲惨	祸患,幸福
谦虚	骄傲,卖弄,自负,狂妄,自满,骄慢,自大,矜持,骄矜,自谦
骄傲	谦虚,气馁,羞愧
快乐	忧愁,伤心,悲伤,苦恼
伤心	高兴,快乐,开心
强健	瘦弱,软弱,衰弱
软弱	强健,刚强,龙锺,坚强,强硬
清澈	浑浊,混浊
浑浊	澄清,明澈,晶莹,清澈,清晰
明白	糊涂,疑惑,暧昧,纳闷
糊涂	明白,清醒,理解,精明
茂密	稀疏,疏落,枯萎
稀疏	朽散,茂密,稠密,繁茂,浓密,密集
伸出	缩回
缩回	伸出
成功	挫折,失败
失败	得胜,胜利,成功
温暖	凉爽,严寒,冰冷,凉快,寒冷,孤独
愤怒	高兴
高兴	扫兴,发愁,气愤,哀痛,悲戚,苦恼,悲伤,烦恼,恼恨,恼怒,难受,痛苦,生气,忧伤,忧郁,不高兴,败兴,愤怒,难过,伤心,沉痛
灵活	笨拙,凝滞,拘泥,呆板,僵化,板滞,机械,死板,迟钝,僵硬
笨拙	蒙懂,能干,颟顸,灵便,伶俐,愚钝,聪明,敏捷,灵活,灵巧
准许	不许,拒绝
拒绝	答理,接受,承诺,同意,乐意,应许,准许,应允,答应,兜揽
热情	淡漠,冷酷,冷落,冷淡,冷漠
冷淡	亲热,殷勤,热情,凶暴隔膜
勤劳	懒惰,怠惰
懒惰	刻苦,勤劳,勤勉,勤快
聚集	弥散,分离,分散
迅速	迟钝,迟缓,缓慢
迟钝	机智,锋利,敏锐,迅速,敏捷,灵活,尖锐,机灵,机敏,灵敏,矫捷,锐敏
认真	马虎,草率,敷衍
马虎	谨慎,澈底,细致,仔细,卖力,不苟,大意,疏漏,慎重,认真
胜利	败北,覆灭,失败
犹豫	坚决,果断,急切,立即,毅然,坚定,执意,干脆
果断	徘徊,优柔,犹豫,踌躇,踟蹰
坚定	动摇,摇动,犹疑,游移,犹豫
动摇	稳固,坚定
膨大	缩小
缩小	放大,夸大,扩大,膨大
笨重	轻便,轻巧,灵巧
轻便	加入,笨重
临时	长期,固定,常久
长期	临时,暂时,瞬间
慎重	马虎,轻率,随便
柔弱	刚强
刚强	懦弱,软弱,柔弱
湿润	干涸,干燥,干枯
光滑	粗糙
静谧	嘈杂,热闹
崭新	破旧,陈旧
陈旧	新鲜,崭新,新款,簇新
开始	终了,结果,关闭,终场,结局,停止,不休,告终,终止,结束,截止,终局,终结,结尾
结尾	开头,开始
漂亮	丑陋
喧闹	寂静,寂寞,宁静,幽静,安静,静寂,譁噪,背静,僻静,沉寂,岑寂,沉默
宁静	喧闹,热闹,嘈杂,烦躁,喧阗
容易	困难,艰难,烦难,为难,难得
困难	容易
凋谢	开放,怒放,盛开
盛开	凋射,凋谢,凋零
朋友	敌人
敌人	人民,友人,朋友,伙伴
山谷	山峰
山峰	山谷,山脊,山脚,山岭
点燃	熄灭,息灭,扑灭
熄灭	点亮,燃烧,点燃
神奇	腐朽,普通,平常
安静	闹热,喧闹,热闹,喧哗,嘈杂,烦躁,吵闹,喧嚣
拽住	放开
放开	跑掉,收拢,拽住,铺开
关心	冷漠,冷落
冷漠	热心,亲切,盛情,关心,热情
高傲	谦逊
谦逊	傲慢,炫耀,高傲,高慢,傲岸
郑重	草率,轻率,随便
轻率	郑重,慎重,隆重
从容	匆猝,急迫,操切,匆促,慌忙,急忙,慌张,仓促,仓猝
慌张	安详,沉着,从容,镇定
奢侈	俭朴,朴素,勤俭,节俭,简朴,寒酸,俭仆
寒酸	奢侈
敏捷	迟钝,笨拙,迟缓
迟缓	急切,躁急,迅速,敏捷
合上	打开
打开	关闭,关了,关掉,合上,关,关上,封闭,盖上
老实	狡诈,调皮,淘气,虚伪,愚直,狡猾,顽皮
狡猾	老实,忠厚,奸邪,诚实
温柔	粗暴
粗暴	和蔼,温柔,和气,温顺
丰富	足够,单调,缺乏,贫乏,匮乏
贫乏	充分,丰饶,富足,丰富,博大,丰足,富饶
难过	高兴,好过
淘气	老实,规矩,乖巧
规矩	放纵,淘气
讨厌	爱慕,喜爱,喜欢,识相,赏识
喜欢	讨厌,厌恶,厌烦,腻烦
反抗	屈服,招安,不屈,压迫,降服,镇压,驯服,制伏,压制,顺从
顺从	反抗,顶撞,违拗
忠厚	奸滑,奸诈,狡猾,奸猾
奸诈	忠厚,忠诚,忠实,赤诚,敦厚
蜿蜒	笔直
坚固	松软,脆弱
陡峭	平缓,平坦
伟大	平凡,渺小
渺小	伟大,雄伟
相同	异样,不同,差异
不同	例外,相同,一律
古老	新颖,年青,现代
宏大	微小
微小	宏大,巨大
魁梧	矮小
矮小	高大,魁梧,颀长
丰满	干瘪,发胀,枯瘦,干瘦
干瘪	丰满,饱满
故人	新交,新朋
新朋	旧雨,故人
无名	知名,闻名,著名,有名
有名	无名
满意	失望,惬意,不满
失望	憧憬,盼望,期望,希望,满意,如愿
灿烂	惨澹,暗淡
暗淡	光亮,绚烂,鲜艳,光明,明亮,灿烂,绚丽,皎洁,闪烁
凋零	稀落,开放,茂盛,盛开
希望	失望
安全	危险
危险	安全,保险,安然,平安
可怜	幸福,可恨
可恨	可怜,可爱
庄重	轻佻,轻浮
轻浮	稳重,严肃,庄重
坚强	懦弱,软弱,脆弱
懦弱	刚强,果敢,坚强,刚毅,坚毅
宽裕	拮据,敷裕,穷困,贫穷
拮据	充裕,宽裕,宽绰
神气	颓丧
颓丧	振作,神气
喜悦	忧伤,悲伤
忧伤	高兴,喜悦,快活,欢乐
悲伤	愉快,喜悦,欢乐,高兴,悲凄,快乐
繁华	萧条,偏僻,冷落,蛮荒,荒凉
萧条	繁华,兴旺,复苏,败落
褴褛	华丽,朴质
华丽	质朴,朴素,简朴,褴褛,朴实
踊跃	消极
消极	踊跃,积极
清晰	漫漶,浑浊,朦胧,混沌,模糊,含糊
仔细	粗心,马虎
粗心	仔细,细心
具体	笼统,大抵,抽象,概括,大略
大略	具体,精确
匆匆	慢慢,姗姗
慢慢	快快,匆匆
认识	陌生
陌生	熟识,认识,不懂,熟悉
疏远	亲近,密切,亲密
亲近	嫌弃,疏远
聪明	笨拙,愚蠢,傻气,愚笨,笨蛋,呆笨
愚蠢	聪慧,乖觉,聪明
长处	短处,缺欠
短处	长处
古代	现代
依赖	自力,独立,自立,仰给
自立	依赖
舒适	艰苦,难受
艰苦	舒适
输入	输出
输出	输入
熟悉	生疏,陌生
关闭	敞开,起动,开设,开放,开,打开,关上,开开,开启,开始
凶猛	温和
温和	炽烈,暴躁,狂暴,严厉,凶猛,凶狠
轻巧	沉重,轻松,笨重
灵敏	迟钝
相似	相反
相反	相似,类似,互异
特殊	凡是,普遍,普通,一般
一般	特殊,格外,典型,独特,个别,特别,专科
美妙	蹩脚
蹩脚	美妙,精彩,精采
优良	恶劣,低劣
低劣	高明,窳陋,优异,拙劣,低能,差劲,优良
俊俏	丑陋
轻快	沉重
沉重	轻盈,轻巧,轻快
鲜艳	暗淡,素净
增添	损耗,削减,减少
削减	增添,增加
活泼	呆滞,呆板,尽情,严肃
呆板	活泼,平板,机灵,灵活,灵巧
停止	不停,继续,进行,间歇,开始
玲珑	粗笨
粗笨	精巧,秀气,玲珑,灵巧,纤巧
送行	迎接
迎接	送行
愈合	开裂
开裂	愈合
离开	接触,挨近,返回,逼近,回归
回归	逃离,叛离,离开
害怕	勇敢
勇敢	害怕,胆小,无畏,胆寒,怯弱,怯懦
飞快	缓慢
镇定	惊慌,惊惶,惊愕,惊讶,诧异,慌乱,颤栗,慌忙,恐慌,慌张,激动,焦急
严寒	温暖,炎热,酷热,酷暑
恶劣	良好,优越,优异,优良
为难	容易
惬意	满意
惊讶	吃惊,镇定
吃惊	惊讶
朦胧	清楚,模糊,清晰
优惠	优待
优待	优惠,虐待,薄待
精巧	粗笨,精致
精致	粗率,粗糙,简陋,精巧
完美	完善,漏洞,破烂
完善	完美
反驳	赞同,反对,支持,附和
反对	配合,支持,赞许,提出,赞同,推戴,不准,拥护,提倡,愿意,甘愿,赞成,响应,反驳
逻辑	规律
规律	逻辑
担心	坚信,放心
放心	担忧,担心,挂心,顾忌,悬念,挂牵,挂虑,挂记,忧虑,顾虑
便宜	昂贵
昂贵	低廉,便宜
兴许	也许
也许	兴许,势必
轻松	繁重,乏累,压抑,紧张,轻巧
率先	首先
首先	起初,率先
忙碌	优游,清闲,闲逸,安闲,闲暇,劳碌
劳碌	忙碌
欣赏	赏识
赏识	欣赏,讨厌
寻觅	寻找
寻找	寻觅,寻得,遗弃
会晤	会见
会见	会晤
感触	感受
感受	感触
振奋	颓靡,颓废,消沉,振作
振作	懊丧,委靡,振奋,颓丧,秀发
生气	高兴,生机
生机	生气
慈祥	慈爱,残酷,狰狞,凶恶,凶狠,狠毒
慈爱	慈祥
忧虑	放心
糟糕	精彩
精彩	蹩脚,平淡,糟糕
感激	仇恨,怨恨,感谢
感谢	感激,抱怨
期望	失望
紧张	松弛,松懈,懒散,弛缓,缓和,轻松,松快
松懈	紧密,紧张
激烈	平稳,平静
狼狈	潇洒
潇洒	狼狈,土气
英勇	怯懦
怯懦	英勇,勇敢
繁荣	萧索,衰微,凋敝,萧瑟,凄凉,凋蔽,衰败,枯朽,荒芜
衰败	昌盛,兴旺,强盛,发达,繁荣,昌隆,鼎盛
权利	义务
义务	权利
穷苦	富裕
富裕	贫寒,竭蹶,贫穷,穷困,贫困,裕如,浊富,穷苦
健康	虚弱
虚弱	强壮,健壮,康健,健康
寂寞	喧闹,热闹,寂寞没有反义词,可以参考孤独的反义词
奴隶	自由民,自由,主人
主人	奴隶,客人,仆人,仆役,奴婢,奴仆,宾客
松弛	紧张
统一	割据,对立,分裂,分化
分裂	对抗,团结,勾结,统一
诚意	假意,虚情
假意	诚意,真心,假心,真情
理屈	理直
理直	理屈
接受	拒绝,推辞,给予,递交,赋予
惩罚	表彰,嘉奖,奖励,犒赏,处治
奖励	责罚,处分,惩罚,惩办
迟延	提前
提前	延缓,挪后,耽搁,延迟,迟延,推迟
示弱	逞强
逞强	示弱
好心	恶意,歹意
恶意	好心,善意,美意
破碎	完好,完整
完整	残破,细碎,零碎,残缺,破碎
酥软	坚硬
坚硬	柔软,酥软,松软
诚实	撒谎,虚假,虚伪,狡猾,说谎
撒谎	坦诚,诚实
正常	失常,畸形,错乱,异样,异常
异常	寻常,平常,正常
非凡	特等,平凡,平庸
平凡	优越,卓越,伟大,希奇,杰出,轩昂,等闲,非凡,出色,不凡,骏逸,超卓
特别	普通,一般
扫兴	高兴,尽兴
轻蔑	尊敬,敬重
敬重	轻慢,轻蔑
开心	悲痛,伤心,苦闷,难受
苦闷	开心,舒畅
寻常	异常,别致
违背	遵从,遵循,按照,依从,服从,严守,遵守
遵循	违反,违背,背离
怀疑	坚信,猜忌,相信
相信	猜疑,怀疑,犯疑
强盛	衰败
尊重	歧视,渺视,凌辱,轻视,侮辱,不齿
侮辱	尊重,尊敬
嘈杂	寂静,宁静,肃静,安静,安谧,静谧,清静
寂静	骚闹,嘈杂,喧闹
信奉	背弃
背弃	鄙视,信奉
失信	守约,守信,取信,背信
守信	失信,食言
率领	追随
追随	率领
退化	进化
进化	退化
凝结	蒸发,融化,离散,溶解
溶解	凝结
减少	增添,增多,增加
酷暑	寒冬,严热,严冬,严寒
安谧	嘈杂,热闹
凉爽	温暖,酷热,阴寒,闷热
柔和	严厉,强烈
严厉	和蔼,温和,柔和
同意	拒绝,禁绝
清醒	陶醉,恍惚,麻木,发昏,昏迷,糊涂
荒芜	耕种,繁荣
耕种	开垦,精熟,荒芜
纯熟	生疏
生疏	熟悉,熟识,了解,烂熟,疏间,熟练,纯熟,谙练,娴熟
随便	不苟,拘谨,严正,慎重,郑重,讲究
厌恶	爱怜,喜爱,喜欢,爱好,厌恨,喜好,佩服
痛快	烦愁,难受
幽静	喧闹
慌忙	从容,镇定
熟识	生疏,陌生
伶俐	笨拙,痴呆,鲁钝
怕羞	大方
大方	吝啬,怕羞,小气,腼腆,忸怩,没羞,羞涩,羞怯
团结	分裂
羞涩	大方
洒脱	庸俗,拘谨
拘谨	自如,洒脱,放肆,放荡,忌惮,随便,奔放
明朗	阴沉,灰暗,阴郁,暗昧,昏暗,低沉
阴沉	明朗
轻盈	沉重
迂回	径直
径直	迂回
饱满	干瘪,空瘪,奋发
衰弱	健壮,强壮,强健,雄壮
丰收	歉收,荒歉,饥馑
歉收	丰产,丰收
淡妆	浓抹
浓抹	浓妆,淡妆
相宜	不宜
不宜	相宜,适宜
自在	拘束
拘束	逍遥,消遥,自在,超脱
奇特	平常
密集	疏散,稀疏,零散,零星,疏落
挺进	撤退,溃退
撤退	挺进,固守,进攻
宽敞	狭窄
倾斜	竖直,垂直
竖直	倾斜
闻名	无名
有趣	无聊,乏味
乏味	没趣,有趣
舒畅	忧闷,郁闷,憋闷,沉闷,惆怅,苦闷,沉郁
结束	开首,开始
整齐	狼藉,参差,零乱,凌乱,杂乱,纷乱,错落,错杂
纷乱	整齐,严整,杂沓,承平
凶恶	平和,慈悲,慈善,良善,善良,慈祥,和善
可爱	可恶,可憎,可恨
可恶	可喜,可爱
附近	远方,遥远,邻近
远方	附近,近处,远处
赞许	反对,责怪
淡水	咸水
咸水	淡水
平淡	精彩,出色,奇观
听从	违抗
违抗	执行,服从,听从
虚伪	诚恳,真挚,赤诚,诚实,老实,真诚
承认	抵赖,翻悔,否认
否认	确认,承认,狡赖
起劲	没劲
没劲	起劲
熟练	生疏
准确	谬误,偏差,错误
错误	正确,准确
暴躁	冷静,柔顺,温顺,温和
近处	远方,远处
远处	远方,近处
气愤	欢喜,高兴
欢喜	气愤
细心	粗心
洁白	乌黑,霉黑
乌黑	雪白,洁白
痛苦	高兴,欢畅,愉快,幸福
新款	陈旧
兴旺	没落,衰败,萧条
常常	偶尔
偶尔	反复,不时,频频,常常,经常,频繁,一贯,屡次,老是
幼稚	老练,成熟
老练	幼稚
含糊	清楚,明确,确切,清晰
严重	轻微
轻微	剧烈,惨重,重大,严重
光明	黑暗,暗淡
黑暗	光明
微弱	强大,强烈,凌厉
强大	微弱,薄弱,弱小
杰出	平凡,凡庸,平庸
平庸	奇巧,飘逸,杰出,珍异,佼佼,非凡,优秀
良好	恶劣
简陋	富丽,豪华,精致,别脚
豪华	俭朴,简陋,简朴
笑盈盈	哭啼啼
哭啼啼	哭咧咧,笑嘻嘻,笑盈盈
笑嘻嘻	,哭啼啼,哭兮兮
	笑嘻嘻
恍恍惚惚	清清楚楚
清清楚楚	恍恍惚惚,隐隐约约,迷迷糊糊
一模一样	截然不同
截然不同	平起平坐,一模一样
柳暗花明	穷途末路,山穷水尽,末路穷途,走头无路
山穷水尽	峰回路转,方便之门,柳暗花明
风平浪静	甚嚣尘上,天摇地动,狂风恶浪,狂风大作,波澜壮阔,风号浪啸,兴妖作怪,此伏彼起,汹涌澎湃,烟波浩渺,波涛汹涌,刀山火海,风号浪吼,惊涛骇浪,轩然大波,风吹浪打
风号浪吼	风平浪静
人声鼎沸	万籁俱静,夜阑人静,鸦雀无声,摇旗呐喊,万籁无声
鸦雀无声	沸反盈天,震耳欲聋,阗寂无声,沸沸扬扬,人声鼎沸
勤勤恳恳	懒懒散散
懒懒散散	勤勤恳恳
一丝不苟	敷衍了事,偷工减料,马马虎虎,粗心大意
敷衍了事	全力以赴,一丝不苟,兢兢业业
隐隐约约	清清楚楚
享誉世界	默默无闻
默默无闻	举世瞩目,崭露头角,石破天惊,尽人皆知,赫赫有名,享誉世界,远近有名,遐迩闻名
相背而行	相向而行
相向而行	相背而行
恍然大悟	百思不解,如坐云雾
百思不解	恍然大悟,心照不宣
筋疲力尽	精神抖擞,容光焕发,精力充沛,干劲十足
精神抖擞	精疲力竭,萎靡不振,意志消沉,筋疲力尽
名副其实	滥竽充数,名不副实,冒名顶替,名存实亡,叶公好龙,画饼充饥,有名无实,色厉内荏
名不副实	名存实亡,名实相副,名过其实,名实难副,名副其实
雪中送炭	雪上加霜,锦上添花,趁火打劫,落井下石,乘人之危,投井下石,雨后送伞
雪上加霜	锦上添花,如虎添翼,雪中送炭
歪歪斜斜	端端正正
端端正正	歪歪扭扭,歪歪斜斜
狂风恶浪	风平浪静
迷迷糊糊	清清楚楚
全神贯注	心不在焉,漫不经心
心不在焉	专心致志,乐此不疲,心猿意马,全神贯注,屏气凝神,聚精会神
断断续续	连续不断,东拉西扯,一气呵成,源源不绝,源源不断,接连不断
连续不断	断断续续
赏心悦目	不堪入目,触目惊心
触目惊心	见而色喜,司空见惯,习以为常,赏心悦目
粗心大意	小心翼翼,一丝不苟,精打细算,谨小慎微,小心谨慎
力倦神疲	精力充沛
精力充沛	精疲力竭,力倦神疲,筋疲力竭,筋疲力尽
万马奔腾	无声无息,万马齐喑
无声无息	震天动地,鸣锣开道,声势浩大,有声有色,惊天动地,鸣锣喝道,如火如荼,震古铄今,万马奔腾
暖暖和和	冷冷清清
冷冷清清	暖暖和和,吵吵嚷嚷,热热闹闹,热火朝天,熙熙攘攘
吞吞吐吐	滚瓜烂熟,干干脆脆,开门见山,直言不讳,畅所欲言
干干脆脆	吞吞吐吐
毫不犹豫	犹豫不决
犹豫不决	毫不犹豫,当机立断,一不做，二不休,死心塌地,斩钉截铁
别具一格	普普通通,千篇一律
普普通通	别具一格
熙熙攘攘	门可罗雀,门庭冷落,冷冷清清,门前冷落
心惊肉跳	镇定自如,心安理得,神色不惊
镇定自如	心惊肉跳
理直气壮	强词夺理,无地自容,理屈词穷
理屈词穷	理直气壮,淋漓尽致,旁征博引,义正辞严,振振有词,振振有辞,名正言顺
一朝一夕	年深日久,匪伊朝夕,久而久之,积年累月,长年累月,通宵达旦,日久天长
日久天长	一朝一夕
悔过自新	执迷不悟
执迷不悟	清夜扪心,改过自新,如梦初醒,改邪归正,翻然悔悟,翻然改进,悬崖勒马,悔过自新,脱胎换骨,发人深省,回头是岸,迷途知反,迷途知返
群策群力	独断专行,一手包办,单刀赴会,孤掌难鸣
孤掌难鸣	群策群力,众擎易举,一呼百诺,一盘散沙
废寝忘食	饱食终日,无所事事,井臼亲操
饱食终日	夙兴夜寐,焚膏继晷,废寝忘食
沸沸扬扬	鸦雀无声,鸦雀无闻
翻来覆去	简单明了
简单明了	翻来覆去
吵吵嚷嚷	冷冷清清
唇枪舌剑	心平气和
心平气和	唇枪舌剑,气急败坏,怨气冲天,意气用事,其势汹汹,恼羞成怒,七窍生烟,气喘吁吁,气冲斗牛,暴跳如雷,喜怒哀乐,怒不可遏,火冒三丈
粗制滥造	精妙绝伦,精雕细刻,精益求精,千锤百炼,鬼斧神工,呕心沥血,精耕细作
精雕细刻	粗制滥造,偷工减料,谨小慎微
安居乐业	颠沛流离,流离失所,流离颠沛,家破人亡,无家可归,四海为家,安家立业,戎马倥偬,民不聊生,十室九空
颠沛流离	安居乐业,安家立业,兵荒马乱
面露愁容	面带微笑
面带微笑	面露愁容
干劲十足	筋疲力尽
成竹在胸	张皇失措,胸有成竹,作舍道旁
胸有成竹	成竹在胸,茫无头绪,心中无数
多	少
上	下2,下,下1
下	上2,上
低	高
黑	白,赤,亮
白	文,皂,黑
天	壤,渊,地
地	空勤,天
男	女
女	男
里	面,外,表
外	内,里
凉	暖,热,温,炎
暖	冷,凉
远	近
近	远
竖	横
涨	缩,降
隐	显,现
现	隐
同	殊,异
异	同
浑	清
清	浑,浊,污
明	暗,幽
嫩	老
凹	凸
凸	凹
母	公
浮	没,潜,沉
沉	浮
朝	夕,暮,野
暮	朝
强壮	衰老,羸弱,衰弱,孱弱,虚弱
哭兮兮	笑嘻嘻
风号浪啸	风平浪静
昏暗	豁亮,皎浩,明朗,明亮
皎浩	昏暗
轻诺寡信	说一是一,一诺千金,说一不二
一诺千金	空头支票,背信弃义,轻诺寡信
上冻	解冻
解冻	上冻,结冰
指不胜屈	屈指可数
屈指可数	不计其数,不一而足,不可胜数,举不胜举,不乏其人,不胜枚举,更仆难数,指不胜屈,擢发难数
购置	变卖
变卖	购置
走投无路	鹏程万里,绝处逢生
绝处逢生	走投无路,束手就擒,枯鱼之肆
中听	难听
难听	悦耳,好听,中听,动听
两全其美	玉石俱焚,两败俱伤
玉石俱焚	两全其美,两败俱伤
国泰民安	狼烟四起,生灵涂炭,国步艰难,内忧外患,民不聊生
国步艰难	国富民强,国泰民安
检点	放肆,放荡,放诞
放荡	检点,拘谨,安分
令人作呕	赞不绝口,令人神往
令人神往	令人作呕
日新月异	故步自封
故步自封	日新月异,标奇立异,一往无前,勇往直前,勇猛求进,取长补短
一往情深	卸磨杀驴,寡情薄义,朝秦暮楚
卸磨杀驴	一往情深
阻塞	通过,畅通
通过	堵住,否决,阻塞
锦衣玉食	布被瓦器,绳床瓦灶
布被瓦器	锦衣玉食
图谋不轨	安分守己
安分守己	胡作非为,图谋不轨,偷香窃玉,横行无忌,好高鹜远,无事生非,无法无天,惹事生非,为非作歹,无所不为,横行霸道
光彩夺目	黯然失色
黯然失色	目光炯炯,光彩夺目
宝货难售	奇货可居
奇货可居	宝货难售
玩物丧志	业精于勤
业精于勤	玩物丧志
甘拜下风	自命不凡,不甘雌伏,迎头赶上,不甘示弱,先声夺人,争长论短
先声夺人	甘拜下风
迥然不同	并驾齐驱,毫无二致
并驾齐驱	相去万里,迥然不同,瞠乎其后
成年	幼年
幼年	成年
珠圆玉润	不堪入耳
不堪入耳	珠圆玉润,余音绕梁,娓娓动听
渊博	鄙陋,浅薄
浅薄	博识,渊博,深厚,渊深,高深
盘马弯弓	引而不发
引而不发	盘马弯弓
奇谈怪论	义正言辞
义正言辞	奇谈怪论
口不应心	言行一致
言行一致	自相矛盾,言行不一,口是心非,自行矛盾,口不应心
寒微	富贵
富贵	贫贱,寒微
吐故纳新	招降纳叛
招降纳叛	选贤任能,吐故纳新
丢弃	拾取,珍藏
拾取	丢弃,抛弃
白文	朱文
朱文	白文
精华	糟粕,粗浅
糟粕	精华,渣滓
鸠形鹄面	形销骨立,脑满肠肥
脑满肠肥	鸠形鹄面,骨瘦如柴
水性杨花	冰清玉洁
冰清玉洁	浅尝辄止,水性杨花,大公无私
一帆风顺	碰钉子,艰难曲折,碰鼻,好事多磨,碰壁,一波三折,逆水行舟,备尝艰苦
逆水行舟	一帆风顺,知难而退
跳梁小丑	正人君子,志士仁人
正人君子	鼠窃狗盗,老奸巨滑,酒色之徒,寻花问柳,投机取巧,跳梁小丑,人面兽心
虾兵蟹将	爪牙之将
爪牙之将	虾兵蟹将
济困扶危	趁火打劫,落井下石
落井下石	从井救人,治病救人,成人之美,济困扶危,扶危济困,救死扶伤,雪中送炭
树大招风	无名小卒
无名小卒	赫赫名流,英雄好汉,风云人物,英雄豪杰,如雷贯耳,超尘拔俗,树大招风
薰莸同器	泾渭分明,薰莸异器
泾渭分明	薰莸同器,认贼作父,泾渭不分,良莠不齐,不问青红皂白
瞻前顾后	当机立断,排除万难,顶天立地,披荆斩棘,一往直前
披荆斩棘	蹈袭故常,养尊处优,畏首畏尾,瞻前顾后
归功	归罪
归罪	宽恕,归功
聊胜于无	不计其数,不胜枚举
不计其数	聊胜于无,寥寥无几,屈指可数
毕业	肄业
肄业	毕业
一览无余	一鳞半爪
一鳞半爪	一览无余,十全十美
元凶	帮凶
帮凶	正凶,元凶
善意	恶意,敌意
敌意	友谊,善意,友情
自高自大	自暴自弃,不耻下问,不矜不伐,自轻自贱
不矜不伐	妄自尊大,自高自大
还礼	敬礼
敬礼	还礼
肉食	草食
草食	肉食
下行	上行
上行	下行
细针密缕	粗枝大叶,粗针大线,大刀阔斧
大刀阔斧	细针密缕,计上心头,束手无策
归去来兮	四海为家
四海为家	归去来兮,安土重迁,安居乐业
喜新厌旧	忠贞不渝,地久天长,惜玉怜香,忠贞不二
惜玉怜香	喜新厌旧,怜新弃旧
一表人才	其貌不扬
其貌不扬	口眼喎斜,千娇百媚,国色天香,眉目如画,仪态万方,一表人才,秀色可餐,花容月貌
慷慨激昂	委靡不振,无精打采
无精打采	慷慨激昂,兴高采烈,发扬蹈厉,神采奕奕
稳	慌
慌	稳
平	皱,陡
皱	平
哑口无言	滔滔不绝,反唇相稽
反唇相稽	哑口无言,唾面自乾,无言以对
主证	旁证
旁证	主证
栽	拔,伐
拔	栽,扎
狂妄	谦虚
大我	小我
小我	大我
果	因
因	果
水中捞月	立竿见影,瓮中捉鳖
立竿见影	水中捞月
喜气洋洋	愁眉苦脸,愁眉锁眼,忧心忡忡
愁眉苦脸	春风满面,喜眉笑脸,满面春风,兴高采烈,欢天喜地,笑逐颜开,笑容可掬,喜气洋洋
旁观	参与,介入
参与	避开,超脱,旁观
贱	贵
贵	贱
面熟	面生
面生	面熟
弹压	安抚,助威
安抚	弹压,讨伐,镇压,征服
好事多磨	一帆风顺
各行其是	遥相呼应,步调一致,同心协力
遥相呼应	各行其是
纳税	徵税,免税
免税	上税,纳税
一干二净	邋里邋遢
邋里邋遢	一干二净
学名	乳名,俗名
乳名	学名,大名
喽罗	头目
头目	喽罗
忘记	记得,记取,惦念
记得	忘记,忘怀
家给人足	艰难竭蹶,民不聊生,日前月腹,啼饥号寒
艰难竭蹶	丰衣足食,家给人足
开胃	反胃
反胃	开胃
粗鲁	优雅,文静,文雅,斯文
文雅	粗俗,粗鲁
朴实大方	花枝招展
花枝招展	朴实大方
朝气	暮气
暮气	朝气
寸步难行	畅通无阻
畅通无阻	寸步难行
英姿飒爽	獐头鼠目
獐头鼠目	英姿焕发,眉清目秀,英姿飒爽,龙眉凤眼
起碇	抛锚
抛锚	起锚,启碇,起碇
悬崖勒马	死皮赖脸,执迷不悟
刁难	配合,成全
成全	作梗,刁难,阻挠
牧工	牧主
牧主	牧工
满载而归	宝山空回,空手而回,一无所获
宝山空回	满载而归
实践	空谈,演习
空谈	实干,实践
揠苗助长	循序渐进
循序渐进	揠苗助长,一步登天,拔苗助长
臣	君
君	臣
处之泰然	操之过急,诚惶诚恐,仓皇失措
操之过急	处之泰然,措置裕如,水磨工夫,四平八稳
坦诚相见	假人假义
假人假义	坦诚相见,肝胆相照
温故知新	数典忘祖
数典忘祖	饮水思源,温故知新
救命之恩	沥血之仇,深仇大恨
深仇大恨	恩重如山,救命之恩
发热	发冷
发冷	发热
收缩	展开,膨胀,伸展
膨胀	收缩
星散	鳞集,云集,赘聚
云集	云散,星散
含辛茹苦	养尊处优,无忧无虑
无忧无虑	含辛茹苦,忧心如焚,心事重重,忧心忡忡
豪华居室	穴居野处
穴居野处	豪华居室
决一死战	不分胜负
不分胜负	决一死战,决一雌雄
他人	自己
自己	他人,己方,别人
精耕细作	粗制滥造
漫不经心	全神贯注,心神恍惚
弹指之间	千秋万代
千秋万代	一年半载,弹指之间
生日	忌日
忌日	寿辰,生辰,生日
虚与委蛇	真心实意,推心置腹,真诚相待
推心置腹	尔虞我诈,虚与委蛇,居心叵测,巧言令色,甜言蜜语
松散	紧密,牢靠,牢固,严密,紧凑,谨严
土崩瓦解	固若金汤
固若金汤	土崩瓦解,不堪一击
摆脱	缠住,陷溺,陷入,依附
依附	摆脱
奇形怪状	司空见惯
司空见惯	奇形怪状,见所未见,闻所未闻,触目惊心,千载难逢,前所未闻,前无古人,晴天霹雳
漫长	短暂
短暂	漫长,长久,久远
本金	利息
利息	本金
锋利	和缓,迟钝
智者千虑	愚者千虑，必有一得
愚者千虑，必有一得	必有一失,智者千虑
实话	空话,大话
空话	实话
妄自尊大	不矜不伐,三顾茅庐,顾影自怜,妄自菲薄,望洋兴叹
堆金积玉	绳床瓦灶
绳床瓦灶	锦衣玉食,堆金积玉
忠言逆耳	甜言蜜语,花言巧语
甜言蜜语	恶语中伤,推心置腹,忠言逆耳,由衷之言
挂虑	放心
平声	仄声
仄声	平声
定	退
出家	还俗
还俗	在俗,出家,落发
坚持不懈	浅尝辄止,半途而废
浅尝辄止	坚持不懈,滴水穿石,持之以恒,冰清玉洁,冰冻三尺，非一日之寒,锲而不舍
小康之家	富商巨贾,豪门大族
富商巨贾	小康之家
不可收拾	蒸蒸日上,旭日东升
蒸蒸日上	每况愈下,江河日下,行将就木,心劳日拙,不可收拾,世风日下
绝唱	败笔
败笔	绝唱
年终	岁首,年初
年初	岁暮,岁终,年底,年末,年终,年尾
席不暇暖	无所事事
无所事事	席不暇暖,日理万机,日不暇给,有所作为,起早贪黑,废寝忘食
笑逐颜开	愁眉苦脸,疾首蹙额,哀毁骨立,忧心忡忡
忧心忡忡	无忧无虑,喜气洋洋,笑逐颜开
千虑一失	千虑一得
千虑一得	千虑一失
血气方刚	暮气沉沉
暮气沉沉	朝气蓬勃,血气方刚
两点论	一点论
一点论	两点论
竖立	放倒
放倒	扶起,竖立
困难至极	顺手牵羊
顺手牵羊	困难至极
厄运	倒霉,衰运,幸运,鸿运
幸运	倒霉,灾祸,不幸,厄运
贪得无厌	两袖清风,分文不取,适可而止,一尘不染
一尘不染	糖衣炮弹,贪得无厌,欲壑难填
生离死别	破镜重圆
破镜重圆	鸾飘凤泊,生离死别,覆水难收
开诚相见	勾心斗角,真诚相见,真诚相对
勾心斗角	开诚相见,精诚团结,披肝沥胆,诡计多端
骚人墨客	胸无点墨,市侩乡愚
胸无点墨	八斗之才,满腹经纶,骚人墨客,著作等身
千里之行，始于足下	好高骛远
好高骛远	千里之行，始于足下,踏踏实实,实事求是,脚踏实地
前仰后合	饮泣吞声,呼天抢地
呼天抢地	前仰后合
言传身教	言而无信
言而无信	一言既出，驷马难追,君子一言，快马一鞭,说一不二,口血未乾,言传身教,信誓旦旦,言而有信
挥霍无度	断齑画粥,克勤克俭,节衣缩食,日积月累
节衣缩食	挥霍无度,铺张浪费
刻骨铭心	过眼烟云
过眼烟云	刻骨铭心
微乎其微	磬竹难书
磬竹难书	微乎其微
硕果仅存	比比皆是
比比皆是	不可多得,无所不有,空前绝后,硕果仅存
切磋琢磨	不相为谋,不求甚解
不求甚解	寻根究底,切磋琢磨
马马虎虎	认认真真,一丝不苟,兢兢业业
文科	理科
理科	文科
一寸光阴一寸金	蹉跎岁月
蹉跎岁月	夜以继日,一寸光阴一寸金,分秒必争
妇孺皆知	鲜为人知
鲜为人知	妇孺皆知
娘家	婆家
婆家	娘家
手足无措	镇定自若,措置裕如
措置裕如	操之过急,手足无措
迎刃而解	治丝益棼
治丝益棼	迎刃而解
珍惜	顾惜,糟踏
糟踏	珍惜,浪费
暗中摸索	老马识途
老马识途	暗中摸索,不知所以
向隅而泣	得意忘形,春风得意
得意忘形	向隅而泣,怅然若失
百思莫解	豁然开朗
豁然开朗	如堕烟海,百思莫解
无济于事	行之有效
行之有效	海底捞月,无济于事,与虎谋皮,以卵投石,劳而无功,海底捞针,徒劳无益
侵吞	退赔
退赔	侵占,侵吞
井蛙之见	高瞻远瞩,博古通今
高瞻远瞩	苟且偷安,杀鸡取卵,目光短浅,目光如豆,急功近利,井蛙之见,鼠目寸光,坐井观天
大显身手	小试锋芒,碌碌无能,牛刀小试
碌碌无能	出类拔萃,大显身手
粗鄙	高雅
高雅	粗俗,粗鄙,通俗,卑俗,鄙俗,鄙俚,精雅
嗷嗷待哺	丰衣足食
丰衣足食	饥寒交迫,啼饥号寒,艰难竭蹶,嗷嗷待哺,一穷二白,缺吃少穿
耳提面命	旁敲侧击
旁敲侧击	单刀直入,开宗明义,耳提面命,直言不讳
肃然起敬	漠然置之,令人齿冷
漠然置之	油然而生,肃然起敬,体贴入微
贬黜	晋升
晋升	贬黜,贬斥
辣手	顺手
顺手	伏手,棘手,辣手,扎手
奴仆	主人
胸中有数	心中无数
心中无数	胸中有数,胸有成竹,心中有数,指挥若定
身败名裂	功成名遂,名满天下
功成名遂	身败名裂
五体投地	不以为然
不以为然	五体投地,仰承鼻息,顶礼膜拜
一步登天	循序渐进,行远自迩,一落千丈
一落千丈	一步登天,突飞猛进,盛极一时,青云直上,扶摇直上,飞黄腾达
唯物史观	唯心史观
唯心史观	唯物史观
浪迹天涯	归心似箭
归心似箭	浪迹天涯,乐不思蜀
说长道短	一言不发
一言不发	高谈阔论,说长道短
束手无策	神机妙算,人急智生,神通广大,机关算尽,机关用尽,大刀阔斧,兵来将挡，水来土掩,千方百计
闭目塞听	耳闻目睹,广开言路,眼观六路,耳聪目明
耳闻目睹	闭目塞听
退隐	出仕
出仕	归田,退隐
隔热	导热
导热	隔热
客观	主观
主观	客观
毛利	净利,纯利
净利	毛利
高枕无忧	杞人忧天,枕戈寝甲,人人自危,安寝无忧,朝不虑夕,大敌当前
大敌当前	歌舞升平,高枕无忧
一寸丹心	狼心狗肺
狼心狗肺	赤子之心,一寸丹心
稠人广众	静室幽居,人烟稀少
人烟稀少	稠人广众
奋勇当先	畏缩不前
畏缩不前	奋勇当先,铤而走险,奋不顾身,首当其冲,挺身而出
七手八脚	有条不紊
有条不紊	七手八脚,胡言乱语,横七竖八,颠三倒四
巩固	削弱,破坏
削弱	加强,增强,巩固
方便之门	山穷水尽,走头无路
应接不暇	应付自如,应付裕如
应付裕如	措手不及,目不暇接,应接不暇
商港	军港
军港	商港
仓促	从容
随心所欲	得心应手,设身处地,循规蹈矩
设身处地	随心所欲
大名	乳名
饿虎扑食	龙困浅滩
龙困浅滩	饿虎扑食
祥瑞	凶兆
凶兆	祥瑞
助桀为虐	除暴安良
除暴安良	以强凌弱,仗势欺人,助纣为虐,趁火打劫,助桀为虐
踌躇	果断
清苦	阔绰
阔绰	清贫,清苦
随机应变	生搬硬套,一成不变
一成不变	因地制宜,千变万化,天翻地覆,翻天覆地,水涨船高,五彩缤纷,另起炉灶,变化莫测,见风使舵,随机应变,沧海桑田,物换星移,风云突变,变幻无常,变幻莫测,白云苍狗,变化无穷,摇身一变,变化多端,一改故辙
害群之马	仁人志士,谦谦君子
谦谦君子	专横跋扈,害群之马,称王称霸
众说纷纭	异口同声,众口一词
异口同声	众说纷纭,仁者见仁，智者见智,莫衷一是,大相径庭
如解倒悬	茹苦含辛
茹苦含辛	如解倒悬
发愤图强	苟且偷安
苟且偷安	高瞻远瞩,发愤图强
满腔热情	冷若冰霜,待理不理
冷若冰霜	温情脉脉,满腔热情,宾至如归
一脉相承	以讹传讹
以讹传讹	衣钵相传,一脉相承
奉若神明	视如敝屣
视如敝屣	奉为圭臬,敝帚自珍,垂涎三尺,奉为楷模,奉若神明
油然而生	漠然置之,戛然而止
一呼百诺	孤立无援,孤掌难鸣
娓娓动听	不堪入耳,一言不语
无视	凝视,重视
重视	鄙薄,藐视,菲薄,无视,鄙视,轻视
发扬蹈厉	无精打采
木已成舟	变幻莫测
变幻莫测	木已成舟,一成不变
秋毫无犯	无恶不作,奸淫掳掠,鸡犬不留,巧取豪夺
巧取豪夺	路不拾遗,乐善好施,秋毫无犯
风吹雨打	风和日丽
风和日丽	风吹雨打
人寿年丰	饥寒交迫,人生如寄,水深火热
人生如寄	人寿年丰
入情入理	不近人情,强词夺理
不近人情	合情合理,悖理违情,入情入理,通情达理
贪官污吏	清正廉明
清正廉明	贪官污吏
哀兵必胜	骄兵必败,骄者必败
骄兵必败	哀兵必胜
仪态万方	其貌不扬
生死存亡	安如泰山
安如泰山	危如累卵,不可终日,生死存亡,岌岌可危,九死一生
直直溜溜	歪歪扭扭
歪歪扭扭	直直溜溜,端端正正
群英荟萃	狐群狗党
狐群狗党	良师益友,群英荟萃
秣马厉兵	刀枪入库
刀枪入库	秣马厉兵
个性	共性
共性	个性
一团乱麻	丝丝入扣
丝丝入扣	乱成一团,东拉西扯,一团乱麻
收盘	开盘
开盘	收盘
歃血为盟	口血未干
口血未干	歃血为盟
多元论	一元论
一元论	多元论
免职	受命,到任,任用,起用
任用	免职,罢免
取长补短	故步自封
轻而易举	难如登天,插翅难飞,来之不易
来之不易	轻而易举,信手拈来
欢送	欢迎,欢＃
欢迎	欢送
心如铁石	喜形于色
喜形于色	心如铁石,闷闷不乐
置若罔闻	充耳不闻,耿耿于怀
耿耿于怀	无介于怀,置之度外,置若罔闻
坦荡如砥	悬崖峭壁
悬崖峭壁	坦荡如砥
恩重如山	绝情寡义,深仇大恨
绝情寡义	恩重如山
大显神通	无能为力,一筹莫展
无能为力	胜任愉快,大显神通,余勇可贾
朴素大方	刁钻古怪
刁钻古怪	朴素大方,平易近人
雕心雁爪	冰壶秋月
冰壶秋月	雕心雁爪
博闻强识	不学无术
不学无术	腹笥甚窘,博古通今,博学多才,真才实学,博闻强记,多才多艺,博闻强识,手不释卷
平起平坐	截然不同
国内	海外,国外,国际
海外	海内,国内
弥散	聚集
物以类聚	水火不容
水火不容	物以类聚,鍼芥相投,胶漆相融
毛骨悚然	镇定自若,面不改容,无所畏惧
镇定自若	人心惶惶,惊慌失措,手足无措,毛骨悚然,胆战心惊,失魂落魄
一见如故	素不相识,视同路人
视同路人	攀龙附凤,一见如故
从长计议	饮鸩止渴,仓促行事,急于求成,竭泽而渔
仓促行事	从长计议
不分皂白	黑白分明,明辨是非
黑白分明	不分皂白,一丘之貉
前所未有	史不绝书
史不绝书	前所未有,史无前例
大彻大悟	鬼迷心窍
鬼迷心窍	大彻大悟
独步天下	狐假虎威
狐假虎威	独步天下
大逆不道	忠心耿耿
忠心耿耿	大逆不道,见异思迁,惹草拈花
久而久之	一朝一夕
人心所向	众叛亲离,怨声载道
怨声载道	有口皆碑,歌功颂德,口碑载道,众口交颂,谢天谢地,普天同庆,众矢之的,人心所向,皆大欢喜
洞天福地	穷巷拙门
穷巷拙门	洞天福地
摘要	全文
全文	提要,摘要
干才	庸才
庸才	干将,干才,英物,无能
身无长技	自成一家
自成一家	身无长技
挖空心思	无所用心
无所用心	挖空心思,费尽心机,惨淡经营,搜索枯肠
惹事生非	安分守己
无神论	有神论
有神论	无神论
近因	远因
远因	近因
进口	国产,出口
出口	进口,入口
鸡犬不惊	鸡犬不留,鸡飞狗窜
鸡犬不留	鸡犬不惊,秋毫无犯
富	穷,贫
穷	富
返回	出发,离开
忍气吞声	据理力争,忍无可忍,宁为玉碎，不为瓦全
宁为玉碎，不为瓦全	忍气吞声
蛇蝎心肠	赤子之心,菩萨心肠
赤子之心	狼心狗肺,蛇蝎心肠
全集	选集
选集	全集
中央	四周,角落,边缘
边缘	边际,中心,中央
未老先衰	返老还童,老当益壮
老当益壮	倚老卖老,老气横秋,未老先衰
开头	煞尾,结尾
美名	臭名,嘉名
臭名	美名
腐朽	神奇,新生
漠视	关注,注视,属意
关注	漠视
外语	母语
母语	外语
涓涓	滔滔
滔滔	涓涓
耐心	急躁,焦急
急躁	沉着,耐心
仁者见仁，智者见智	异口同声
饱食暖衣	无衣无食
无衣无食	饱食暖衣
独断专行	群策群力,从善如流,集思广益
集思广益	闭门造车,独断专行,一意孤行
有人撑腰	无依无靠
无依无靠	有人撑腰,大有靠山
出其不意	不出所料
不出所料	出人意表,出乎意料,出人意料,出其不意
尽人皆知	默默无闻
饱经风霜	养尊处优,新硎初试
养尊处优	苦大仇深,积劳成疾,含辛茹苦,披荆斩棘,饱经风霜
莫衷一是	各执一词,众口纷纭,异口同声,一针见血
一针见血	隔靴搔痒,莫衷一是
高谈阔论	沉默寡言,缄口结舌,不苟言谈,一言不发
急于求成	按部就班,从长计议
畅达	晦涩
晦涩	流畅,畅达,晓畅
昏头昏脑	心明眼亮,神志清醒
神志清醒	昏头昏脑
流离失所	安居乐业
天不作美	三生有幸
三生有幸	天不作美
弹无虚发	无的放矢
无的放矢	弹无虚发,有的放矢,对症下药,百步穿杨,箭不虚发
赞成	反对
一拍即合	话不投机,方枘圆凿
方枘圆凿	一拍即合
过午	头午
头午	过午
后发制人	先发制人,先睹为快
先发制人	后发制人
志在四方	胸无大志
胸无大志	志在四方
有板有眼	乱七八糟,马虎从事
乱七八糟	有板有眼,井井有条,整整齐齐,有条有理,井井有理
乱	安,齐,治
齐	乱
失魂落魄	镇定自若,泰然自若,得其所哉
泰然自若	人心惶惶,如坐针毡,惊慌失措,魂飞魄散,惊恐万分,不尴不尬,闻风丧胆,心惊胆战,失魂落魄,忐忑不安
吐	吞
吞	吐
天摇地动	风平浪静
假手于人	公而忘私
公而忘私	私而忘公,假公济私,自私自利,假手于人
无影无踪	蛛丝马迹
蛛丝马迹	千丝万缕,无影无踪
小试锋芒	大显身手
怠惰	勤劳,嬉游,懒怠
老牛破车	快马加鞭,风驰电掣
快马加鞭	老牛破车
细则	总纲
总纲	细则
记性	忘性
忘性	记性
鸟瞰	仰望
仰望	鸟瞰,俯看,俯瞰,俯视
史无前例	接连不断,史不绝书
接连不断	断断续续,史无前例
宠辱不惊	宠辱若惊
宠辱若惊	宠辱不惊
鱼贯而入	破门而入
破门而入	破门而出,鱼贯而入
交头接耳	大声喧哗
大声喧哗	交头接耳
荒无人烟	稠人广座
稠人广座	荒无人烟
行有余力	心有余而力不足
心有余而力不足	行有余力
整齐划一	井然有序,参差不齐
参差不齐	整齐划一,鳞次栉比
置身其中	置身事外,作壁上观
置身事外	置身其中,责无旁贷
呼之欲出	平淡无奇
平淡无奇	出神入化,非驴非马,绘声绘色,悲欢离合,动人心弦,呼之欲出,奇花异草,离奇曲折,有声有色,诗情画意,异乎寻常,无奇不有,生花妙笔
解甲归田	穷兵黩武
穷兵黩武	休养生息,解甲归田,斫伐过度,偃武修文,和平共处
忍无可忍	忍辱负重,忍气吞声
酣畅淋漓	扦格不通
扦格不通	酣畅淋漓
旧雨重逢	冤家路窄,失之交臂
失之交臂	机不可失,不期而遇,旧雨重逢
入世不深	老谋深算
老谋深算	入世不深,初出茅庐
炙手可热	平易近人
平易近人	炙手可热,飞扬跋扈,刁钻古怪,目中无人,盛气凌人
我行我素	言听计从
言听计从	我行我素
封妻荫子	祸灭九族
祸灭九族	封妻荫子
翻然悔悟	死不改悔,执迷不悟
上级	下级
下级	上级,部下,同级
责怪	道歉,赞许,赞美
不动声色	虚张声势,惊惶失措,若有所失,声色俱厉,惊恐万分,惊恐万状
声色俱厉	不动声色
千变万化	千篇一律,一成不变
千篇一律	物极必反,照猫画虎,千变万化,独出心裁,千奇百怪,匠心独运,别树一帜,独具匠心,天渊之别,别具一格
奋发图强	安於现状,及时行乐
及时行乐	乐极生悲,奋发图强
徒劳无益	行之有效,劳苦功高
颠三倒四	头头是道,顺理成章,井井有条,有条不紊
顺理成章	颠三倒四,语无伦次,倒行逆施
化缘	布施
布施	化缘
原形毕露	匿影藏形,乔装打扮
乔装打扮	本来面目,原形毕露
博采众长	刚愎自用,自以为是
刚愎自用	满招损，谦受益,博采众长,遂非愎谏,虚怀若谷
锲而不舍	一暴十寒,浅尝辄止,三天打鱼，两天晒网,半途而废,知难而退
慑服	顽抗,悦服
悦服	慑服
高视阔步	敛首低眉,鹅行鸭步
鹅行鸭步	高视阔步
功败垂成	水到渠成,大功告成
水到渠成	功败垂成,徒劳无功
自告奋勇	畏葸不前,畏首畏尾,无路请缨
畏首畏尾	敢作敢为,当机立断,敢想敢干,豪放不羁,披荆斩棘,万死不辞,无所顾忌,义无反顾,自告奋勇,无所畏惧
东拉西扯	断断续续,丝丝入扣
克己奉公	假公济私,利欲熏心,公报私仇
利欲熏心	克已奉公,克己奉公
冰冻三尺，非一日之寒	浅尝辄止
复刊	停刊
停刊	复刊
知难而退	逆水行舟,无所作为,知难而进,锲而不舍
招摇撞骗	实事求是
实事求是	指鹿为马,弄虚作假,添油加醋,先入为主,盗名欺世,断章取义,自吹自擂,添枝加叶,好高骛远,颠倒黑白,招摇撞骗,故弄玄虚,哗众取宠,巧立名目,颠倒是非
速	缓
完璧归赵	支离破碎
支离破碎	完璧归赵,浑然一体,完整无缺
片言只语	连篇累牍,片纸只字
连篇累牍	片言只语,断简残编,片言只字
活动	静养,静止j,固定,静止
固定	活动,浮动,机动,摇摆,临时,变动,流动
求胜	求和
求和	求战,求胜
余勇可贾	无能为力,精疲力竭
不惑之年	豆蔻年华
豆蔻年华	不惑之年
浴血奋战	和平共处
和平共处	大张挞伐,穷兵黩武,浴血奋战,枪林弹雨,弱肉强食,鹿死谁手
偶一为之	韦编三绝,勤学苦练
韦编三绝	偶一为之
公布于众	难言之隐
难言之隐	公布于众
推销	收购,搜购
收购	推销,销售
改朝换代	铁打江山
铁打江山	改朝换代
各奔前程	分道扬镳,万众一心,相依为命,众星捧月
万众一心	各奔前程
尽心竭力	忠於所事,敷衍塞责
敷衍塞责	尽心竭力,殚精竭虑,匹夫有责
开化	愚昧,冻冰
愚昧	聪颖,开化
招摇过市	匿影藏形
匿影藏形	招摇过市,水落石出,原形毕露,粉墨登场
康健	虚弱
宾至如归	冷若冰霜
抓	放
放	抓,录,捉
推诚相见	明争暗斗
明争暗斗	精诚团结,肝胆相照,推诚相见
真伪莫辨	昭然若揭,真相大白
真相大白	真伪莫辨,不白之冤,深不可测
数一数二	不足为奇
不足为奇	大惊小怪,难能可贵,数一数二
寥寥可数	成千上万,盈千累万
成千上万	寥寥无几,寥寥可数
先手	后手
后手	先手
心有余悸	神色不惊
神色不惊	心惊肉跳,心有余悸
锄强扶弱	以强凌弱,仗势欺人
仗势欺人	除暴安良,锄强扶弱
闪烁其辞	心直口快,拐弯抹角,锋芒逼人
锋芒逼人	闪烁其辞
红口白牙	隐恶扬善
隐恶扬善	吹毛求疵,红口白牙
外柔内刚	外强中干
外强中干	外柔内刚,外圆内方
互为表里	行同陌路
行同陌路	花前月下,互为表里,称兄道弟
零售	批发,零卖
批发	零售,零卖
食不甘味	心安理得
心安理得	食不甘味,方寸已乱,心中有愧,诚惶诚恐,寝食不安,心烦意乱,心惊肉跳,坐立不安,坐卧不安,问心有愧,惴惴不安,心乱如麻,忐忑不安,七上八下
以理服人	以力服人
以力服人	以理服人
危如累卵	安如泰山,稳如泰山
针锋相对	犯而不校,吠影吠声,相忍为国,气味相投,逆来顺受
相忍为国	针锋相对
返老还童	齿豁头童,老态龙锺,未老先衰
模糊不清	炯炯有神
炯炯有神	模糊不清
失陷	光复
光复	沦陷,失陷
虚岁	足岁,实岁
足岁	虚岁
深刻	肤浅,肤泛
肤浅	浮浅,深长,彻底,芜浅,深透,深刻,透辟,精深,深邃
推三阻四	义不容辞,当仁不让
当仁不让	推三阻四,临阵脱逃
查封	启用
启用	查封,停用
画饼充饥	名副其实
恶语中伤	甜言蜜语
揭开	覆盖,隐蔽
覆盖	掀开,揭开
短途	长途,远程,短程
长途	短途
三言两语	絮絮不休,讨价还价,喋喋不休
讨价还价	宽宏大量,三言两语
下场	上场
上场	退场,下场
文质彬彬	赳赳武夫,威风凛凛,野调无腔
野调无腔	文质彬彬
虚无缥缈	坚定不移
坚定不移	虚无缥缈,举棋不定
壅塞	疏通
疏通	淤塞,壅塞,堵塞
评头品足	无可非议,无可厚非
无可非议	评头评足,张冠李戴,评头品足
整装	散装
散装	集装,整装
万籁无声	震耳欲聋,人声鼎沸
开放	闭塞,关闭,凋零,凋谢,怒放,封闭,梗阻,封锁
封锁	开放,透露
味如嚼蜡	回味无穷
回味无穷	味如嚼蜡
生气勃勃	一息奄奄,槁木死灰,死气沉沉
槁木死灰	生气勃勃
残山剩水	锦绣河山
锦绣河山	残山剩水
法人	自然人,自然
自然人	法人
扑朔迷离	一清二楚,不言而喻
不言而喻	扑朔迷离
晚点	正点
正点	脱班,晚点,误点
厚今薄古	厚古薄今
厚古薄今	厚今薄古
兴起	衰亡
衰亡	兴起
万事大吉	艰难曲折,节外生枝
艰难曲折	一帆风顺,万事亨通,万事大吉
琅琅上口	佶屈聱牙,诘屈聱牙
佶屈聱牙	琅琅上口,出口成章
心照不宣	百思不解
费力	省力,讨巧
省力	费力,省劲
江心补漏	临渴掘井,防微杜渐
防微杜渐	江心补漏
离队	归队
归队	改行,离队
洁身自好	同流合污,明哲保身
同流合污	明哲保身,洁身自好,疾恶如仇
情随事迁	始终不渝
始终不渝	翻云覆雨,情随事迁,自始至终,朝秦暮楚
丰沛	稀少
稀少	繁多,稠密,丰沛,众多
一团和气	凶神恶煞,凶相毕露,蛮横无理
蛮横无理	悖理违情,一团和气
无可厚非	评头品足
曲意逢迎	直言不讳
直言不讳	指桑骂槐,钳口结舌,心直口快,吞吞吐吐,旁敲侧击,隐约其辞,话中有话,讳莫如深,曲意逢迎
开市	收市
收市	开市
另起炉灶	一如既往,一成不变,双管齐下
一如既往	时过境迁,世态炎凉,判若两人,朝令夕改,另起炉灶,一反常态,取而代之
情有可原	不可思议
不可思议	情有可原,可想而知
克制	放纵
放纵	规矩,抑制,克制,羁縻,管束,收敛,按捺,管教
分秒必争	坐失良机,尸位素餐,因循坐误,蹉跎岁月
下里巴人	曲高和寡,阳春白雪
阳春白雪	下里巴人
食言	守信
殊途同归	南辕北辙,背道而驰
南辕北辙	马首是瞻,殊途同归
残兵败将	人强马壮,百万雄师
人强马壮	人仰马翻,残兵败将
邪门歪道	光明磊落
光明磊落	心怀坦白,蝇营狗苟,偷梁换柱,鬼鬼祟祟,邪门歪道,寡廉鲜耻,上下其手,心怀叵测
糟蹋	保护,爱惜
保护	裨益,迫害,毁坏,残害,损伤,摧残,损坏,损害,糟害,增益,糟蹋,破坏
灵通	闭塞
闭塞	开放,畅通,灵通
心甘情愿	死不瞑目,死不甘心,万不得已,抱恨终天,强人所难,迫不得已
抱恨终天	心甘情愿,死而无憾
七上八下	心安理得
终了	开始
昂首望天	眼睛向下
眼睛向下	昂首望天
诚惶诚恐	处之泰然,心安理得
彼竭我盈	迎风而行
迎风而行	彼竭我盈
鼠窃狗盗	正人君子,江洋大盗
黄昏	清晨,黎明,拂晓
清晨	黄昏,夜阑
取而代之	一如既往
苦头	甜头
甜头	苦头
切中要害	隔靴骚痒,隔靴搔痒
隔靴骚痒	切中要害
脱离	离异,皈依,联系
联系	孤立,脱节,脱离
众口交颂	怨声载道
墨守成规	标新立异,通权达变,别创新格,匠心独运,朝三暮四,推陈出新
推陈出新	墨守成规,安常守故,食古不化,抱残守缺,清规戒律,循规蹈距
刎颈之交	素昧平生
素昧平生	莫逆之交,刎颈之交
无往不胜	屡战屡败
屡战屡败	立于不败之地,无往不胜,所向无敌
突飞猛进	一落千丈,江河日下,以退为进
江河日下	蒸蒸日上,突飞猛进,如日方升,每下愈况,飞黄腾达
历届	应届
应届	历届
跃然纸上	刻鹄类鹜,画虎类犬
画虎类犬	维妙维肖,惟妙惟肖,跃然纸上
不相为谋	以邻为壑,切磋琢磨
妖魔鬼怪	麟凤龟龙
麟凤龟龙	妖魔鬼怪
出售	购买
购买	卖出,出售,销售
混淆是非	明辨是非
明辨是非	不分皂白,混淆是非
功成不居	居功自傲
居功自傲	功成不居
歪门邪道	不二法门
不二法门	歪门邪道
不务正业	奋发有为
奋发有为	不务正业
认认真真	马马虎虎
个人	团体,大家,组织,集体
集体	个人
休息	劳动,做事,工作,劳顿,游玩
工作	作工,休息,消遣
节外生枝	万事大吉
作茧自缚	嫁祸于人
嫁祸于人	作茧自缚,反躬自问,作法自毙
穷年累月	顷刻之间
顷刻之间	穷年累月
凶神恶煞	好好先生,一团和气
好好先生	凶神恶煞
屡教不改	幡然悔悟,浪子回头
幡然悔悟	屡教不改
事在人为	听天由命
听天由命	事在人为,何去何从,成事在人,改天换地
彪形大汉	白面书生
白面书生	彪形大汉,花花公子
无言以对	对答如流,反唇相讥,反唇相稽
干瘦	丰满,富态,肥胖,丰盈
肥胖	瘦削,干瘦,苗条,消瘦,发胖
独立自主	俯仰由人,依草附木,仰人鼻息,不由自主
不由自主	独立自主
豪门大族	小康之家
巧妇难为无米之炊	指雁为羹
指雁为羹	巧妇难为无米之炊
自以为是	博采众长,虚怀若谷
高深	浅薄
收方	付方
付方	收方
响彻云霄	闷声不响
闷声不响	响彻云霄
高歌	低吟
低吟	呐喊,高唱,默读,高歌
偷梁换柱	光明磊落
一代风流	一代奸雄
一代奸雄	一代风流
神色自若	呆若木鸡,目瞪口呆
呆若木鸡	神色自若,奔走相告
开通	古板,守旧,迂腐
迂腐	开通
不时之需	一定之规
一定之规	不时之需,奥妙无穷
其势汹汹	心平气和
加强	削弱,减弱
私邸	私宅,官邸,公寓
官邸	私邸
已然	未然
未然	已然
仗义疏财	锱铢必计,谋财害命,爱财如命
爱财如命	一掷千金,挥金如土,仗义疏财,克劝克俭
丰厚	菲薄
菲薄	厚实,重视,丰厚,优厚
农历	公历,西历
公历	农历,夏历
脚踏实地	譁众取宠,白日做梦,好高骛远
千辛万苦	娇生惯养
娇生惯养	百炼成钢,千辛万苦
净化	污染
污染	净化
逍遥自在	提心吊胆,胆战心惊
胆战心惊	镇定自若,逍遥自在
洗心革面	怙恶不悛,顽固不化
顽固不化	悔之无及,洗心革面,改过自新
确切	含糊
捷径	弯路
弯路	捷径
悭吝	慷慨
慷慨	吝啬,悭吝
工整	潦草
潦草	工整
客人	主人
同生共死	你死我活
你死我活	生死与共,同生共死
无懈可击	有机可乘,破绽百出,七拼八凑,无孔不入,乘虚而入
有机可乘	无机可乘,无懈可击,无隙可乘
宾	主
百炼成钢	娇生惯养,一人传虚，万人传实
一人传虚，万人传实	百炼成钢
尔虞我诈	肝胆相照,推心置腹,披肝沥胆,开诚布公
积善得果	咎有应得
咎有应得	积善得果
才疏志浅	才高八斗
才高八斗	才疏志浅
慈眉善目	青面獠牙,暴戾恣睢
青面獠牙	绝代佳人,慈眉善目,明眸皓齿
先	后
油腔滑调	不苟言笑,一本正经
不苟言笑	道貌岸然,嬉皮笑脸,谈笑风生,油腔滑调
指示	请示
请示	指示,批准,汇报
风雨飘摇	岿然不动,稳如泰山
岿然不动	摇摇欲坠,安如磐石,坚不可摧,逃之夭夭,风雨飘摇
止于至善	毫无是处
毫无是处	止于至善
掩蔽	暴露
暴露	埋伏,遮蔽,掩盖,掩蔽,隐藏,揭示,藏匿,躲藏,隐蔽,坦率,坦露
舍死忘生	贪生怕死
贪生怕死	舍生忘死,同归于尽,舍死忘生,视死如归,出生入死,前仆后继,奋不顾身
簇新	残旧,陈旧
三五成群	形单影只
形单影只	三五成群,前呼后拥,形影相吊,孑然一身,成群结队,门庭若市
重温旧梦	永不相见
永不相见	重温旧梦
闭门造车	集思广益
递交	接受
一文不值	无价之宝,一字千金
无价之宝	贱如粪土,一文不值
喋喋不休	默默无声,默默无言,三言两语
青出于蓝	不可企及
不可企及	后来居上,青出于蓝
拾金不昧	财迷心窍,敲诈勒索
财迷心窍	拾金不昧
绝代佳人	青面獠牙
赐予	乞求,掠夺
乞求	恩赐,赐予,施舍
担惊受怕	稳如泰山
稳如泰山	担惊受怕,危如累卵,摇摇欲坠,岌岌可危,一发千钧,慌手慌脚,风雨飘摇
疏导	堵塞
堵塞	疏通,通畅,疏导
超尘拔俗	无名小卒,芸芸众生
拈轻怕重	勇挑重担,不辞劳苦
不辞劳苦	拈轻怕重,好逸恶劳
出卖	收买
收买	出卖
春意阑珊	春意盎然
春意盎然	春意阑珊,春寒料峭
真诚相待	虚与委蛇
赔本	赚钱
赚钱	赔帐,赔本
人外有人	无以复加
无以复加	人外有人
造作	自然
自然	尴尬,造作,法人,发窘,生硬,人为,做作
开幕词	闭幕词
闭幕词	开幕词
万人空巷	穷乡僻壤
穷乡僻壤	十字街头,鸟语花香,万人空巷,通都大邑,沃野千里
贫嘴薄舌	沉默寡言
沉默寡言	刺刺不休,贫嘴薄舌,七嘴八舌,呶呶不休,高谈阔论,侃侃而谈,津津乐道
蚀本	盈利
盈利	蚀本,亏本,折本
混淆	划清,澄清
划清	混淆
稀薄	浓密,粘稠,浓重,浓厚
浓厚	稀薄
闲事	正事
正事	闲事
慈	狠
狠	慈
价值连城	一钱不值
一钱不值	价值连城
雄才大略	庸庸碌碌,雕虫小技
庸庸碌碌	雄才大略,卓卓铮铮
十字街头	穷乡僻壤
枯鱼之肆	绝处逢生
万古千秋	一年半载
一年半载	千秋万代,万古千秋
事出有因	平白无故
平白无故	事出有因
所向无敌	屡战屡败,望风披靡,三战三北
柔顺	暴躁
地支	天干
天干	地支
化装	卸装
卸装	化装,上装,下装,打扮
人才济济	人才零落
人才零落	人才济济
扎	解,拔
解	扎,结,系
和衷共济	离心离德,自甘雌伏,分庭抗礼
分庭抗礼	和衷共济,同心协力
一以贯之	虎头蛇尾
虎头蛇尾	有头无尾,有头有尾,始终不懈,有始有终,水滴石穿,愚公移山,一以贯之
百万雄师	残兵败将
粗茶淡饭	山珍海错,纸醉金迷,山珍海味
山珍海味	美馔佳肴,残杯冷炙,残羹冷炙,粗茶淡饭,粗衣粝食,家常便饭
天渊之别	伯仲之间,千篇一律,大同小异
停滞不前	斗转星移,新陈代谢,马不停蹄,急起直追,固步自封
斗转星移	停滞不前
养精蓄锐	竭尽全力
竭尽全力	养精蓄锐
停职	复职
复职	罢官,解职,停职,罢职
油嘴滑舌	一本正经
一本正经	正色庄容,油嘴滑舌,嘻皮笑脸,嬉皮笑脸,不伦不类,油腔滑调
扬汤止沸	釜底抽薪,灭火去薪
灭火去薪	扬汤止沸
茅塞顿开	冥顽不灵
冥顽不灵	茅塞顿开,聪明睿智,聪明才智
室内	露天
露天	室内
天壤之别	伯仲之间,毫无二致,相差无几,宵壤之别
相差无几	天壤悬隔,天壤之别
暗淡无光	云蒸霞蔚
云蒸霞蔚	暗淡无光
悔恨交加	问心无愧
问心无愧	心中有愧,悔恨交加
张冠李戴	无可非议,毫厘不爽
顶礼膜拜	不以为然
邪说	真理
真理	邪说,谬论,谬误
付之一笑	大笑不止
大笑不止	付之一笑
一刻千金	度日如年,一日三秋
度日如年	光阴似箭,寒来暑往,一刻千金,似水流年,白驹过隙,时光冉冉
简明	烦琐,稠浊
烦琐	简明,简约
胆大妄为	战战兢兢,前怕狼，后怕虎
战战兢兢	胆大妄为,袒自若
教	学
学	教
抗击	进攻
进攻	抵挡,还击,防御,抗击,坚守,撤退,防守
万无一失	防不胜防
防不胜防	万无一失,料事如神
富贵不能淫	见利忘义
见利忘义	见利思义,富贵不能淫,见义勇为,利令智昏
简便	繁琐,麻烦
麻烦	不便,便当,阻逆,简便,便利,方便,留难
虎头虎脑	猴头猴脑
猴头猴脑	虎头虎脑
区区小事	非同小可
非同小可	区区小事
水泄不通	川流不息
川流不息	水泄不通
寥落	稠密
稠密	稀疏,寥落,稀少
分外	分内
分内	额外,分外
简短	冗长
冗长	简洁,简短,精练,凝练
论功行赏	无功受禄
无功受禄	论功行赏,一无所得,按劳分配
迷离恍惚	一目了然
一目了然	雾里看花,目不暇给,若明若暗,迷离恍惚,若隐若现,不可捉摸
粗浅	奥妙,精辟,精华,深奥,精湛
深奥	浅显,粗浅,浅近
艰苦卓绝	好逸恶劳
好逸恶劳	艰苦卓绝,旰食宵衣,不辞劳苦,摩顶放踵
下不为例	不厌其烦,不乏先例
不乏先例	下不为例
埋藏	开掘
开掘	埋藏
蔑视	珍视,贱视,崇拜,敬意,崇敬
崇敬	鄙弃,蔑视
苦不堪言	无比欢欣,喜之不尽
喜之不尽	苦不堪言
昌盛	衰落,衰败
衰落	蓬勃,昌盛,倔起,兴盛,发展,勃兴,复兴
蓬门荆布	金枝玉叶
金枝玉叶	蓬门荆布
余音绕梁	不堪入耳
质朴无华	珠光宝气
珠光宝气	质朴无华,荆钗布裙
闭关锁国	门户开放,面向世界
面向世界	闭关锁国
鸡零狗碎	荦荦大端
荦荦大端	细枝末节,鸡毛蒜皮,鸡零狗碎
注解	正文
正文	附录,注释,注解
有求必应	拒之门外
拒之门外	有求必应,来者不拒
哑然失笑	哄堂大笑
哄堂大笑	哑然失笑
和婉	尖酸
尖酸	和婉
薄情	多情
多情	无情,薄情,寡情
胆大包天	胆小如鼠,泼天大胆
胆小如鼠	胆大包天,矜才使气,浑身是胆,不入虎穴，焉得虎子
焚膏继晷	饱食终日
枯木朽株	根深叶茂,万紫千红
万紫千红	枯木朽株
羽毛未丰	羽毛丰满,炉火纯青,羽翼已成
羽毛丰满	羽毛未丰
餐风露宿	席丰履厚,悠哉游哉
悠哉游哉	餐风露宿
注销	登记
登记	注销
春风满面	愁眉苦脸
僚机	长机
长机	僚机
出口成章	语无伦次,佶屈聱牙,不知所云
升华	凝华
凝华	升华
群魔乱舞	乐善好施
乐善好施	下井投石,巧取豪夺,豺狼成性,群魔乱舞,敲骨吸髓,伤天害理
偷偷摸摸	别有用心,明目张胆,正大光明
正大光明	偷天换日,鬼鬼祟祟,正正经经,偷偷摸摸,心怀鬼胎,心怀叵测
省心	操心
操心	省心,安心
孤岛	群岛
群岛	孤岛
如梦方醒	黄梁美梦
黄梁美梦	如梦方醒
风仪秀整	蓬头垢面
蓬头垢面	眉清目秀,风仪秀整,盛饰严装
关内	关东,关外
关外	关内
百战不殆	一败涂地,不败之地
一败涂地	百战不殆,大获全胜
截长补短	将错就错
将错就错	知过必改,过而能改,截长补短,将功补过
缄口结舌	大放厥词,高谈阔论,侃侃而谈
大放厥词	缄口结舌
隆冬	盛夏,炎夏
盛夏	隆冬
子女	父母
父母	子女
好听	难听
执政	在野
在野	执政,在朝
白璧微瑕	白璧无瑕
白璧无瑕	瑕瑜互见,白壁微瑕,白璧微瑕
应邀	邀请
邀请	应邀
心满意足	诛求无厌,得寸进尺,心如刀绞
心如刀绞	心满意足
一花独放	百花齐放
百花齐放	一花独放,残花败柳
师出有名	兵出无名,师出无名
师出无名	师出有名,名正言顺
相见恨晚	视如寇仇,白头如新
白头如新	相见恨晚
积劳成疾	养尊处优
高八斗	才疏学浅
才疏学浅	才气过人,经天纬地,才高行洁,高八斗,学问渊博
伤感	欣慰
欣慰	伤感
残杯冷炙	山珍海味
宽大为怀	杀一儆百
杀一儆百	以一警百,宽大为怀
散发	收集
收集	蕴蓄,散发,释放
暂短	长久
长久	短暂,暂短,暂时,长远
目不暇接	应付裕如,目不忍睹
目不忍睹	目不暇接
走运	倒运,背时
倒运	走运
新式	老式
老式	时式,新式
分别	相逢,见面
见面	告别,分别,分手
入耳	逆耳
逆耳	入耳,顺耳
正品	次品,残品,废品
次品	正品
秋	春
春	秋
弄虚作假	实事求是
提要	全文
手到擒来	大海捞针
大海捞针	信手拈来,手到擒来
改天换地	听天由命
龙争虎斗	团结友爱
团结友爱	龙争虎斗
枕戈待旦	高枕而卧,醉生梦死
醉生梦死	枕戈待旦
细水长流	大手大脚
大手大脚	精打细算,省吃俭用,细水长流,小手小脚
暗渡陈仓	明火执杖,明目张胆
明火执杖	暗渡陈仓
以德报怨	刻骨仇恨,以怨报德,倒打一耙,以德报德
倒打一耙	以德报怨
引人注目	隐姓埋名
隐姓埋名	引人注目,出头露面,抛头露面
众擎易举	一木难支,众志成城,孤掌难鸣
提升	降低
降低	升高,调高,提高,提升
一无所有	无所不有,包罗万象
包罗万象	寥寥无几,东鳞西爪,空空如也,一无所有,挂一耭
榜上有名	榜上无名
榜上无名	榜上有名,名列前茅
烦难	容易
里面	外面
外面	里面,内面
大快人心	民怨沸腾
民怨沸腾	大快人心,万流景仰
清心寡欲	多多益善
多多益善	清心寡欲,不忮不求
防御	进攻
鼓劲	泄气
泄气	鼓劲
独善其身	心怀天下
心怀天下	独善其身
绘声绘色	平淡无奇
质朴	华丽
披挂上阵	赤膊上阵
赤膊上阵	披挂上阵,披坚执锐
连	断
售	购
购	售,销
失传	流传
流传	失传
左右为难	左右逢源
左右逢源	内外交困,左右为难,望眼欲穿,四面受敌
肌瘦如柴	虎背熊腰
虎背熊腰	弱不禁风,肌瘦如柴
仁慈	毒辣,刁悍,凶暴,暴虐,凶残,残忍,残酷,残暴
凶残	仁慈
又红又专	只专不红,只红不专
只专不红	又红又专
繁盛	残败,枯萎
毫不留情	手下留情
手下留情	执法如山,毫不留情
元配	填房,继配
填房	元配
坚如磐石	摇摇欲坠,牢不可破,不堪一击
摇摇欲坠	岿然不动,坚如磐石,安如磐石,傲然屹立,稳如泰山,根深蒂固
合情合理	不近人情,岂有此理,没法没天
不伦不类	一本正经
假公济私	廉洁奉公,公而忘私,公事公办,奉公守法,克己奉公
负心	痴情
痴情	负心
耳软心活	固执己见
固执己见	耳软心活,人云亦云
蹑手蹑脚	大大方方
大大方方	蹑手蹑脚
风流倜傥	衣衫褴褛
衣衫褴褛	峨冠博带,风流倜傥,衣冠楚楚
前功尽弃	大功告成
大功告成	前功尽弃,功败垂成,功亏一篑
奉为圭臬	视如敝屣,视如草芥
披肝沥胆	勾心斗角,钩心斗角,假仁假义,尔虞我诈
允许	禁止
禁止	容许,允许,不容
执法如山	从宽发落,手下留情
兵不血刃	血流漂杵,血流成河,血流飘杵
血流飘杵	兵不血刃
顶撞	顺从
量入为出	入不敷出
入不敷出	量入为出
无关痛痒	漠不相关,切肤之痛,事关全局,生死攸关
生死攸关	无关痛痒
百家争鸣	万马齐喑
万马齐喑	百家争鸣,万马奔腾
奉公守法	假公济私,违法乱纪,作奸犯科,为非作歹
孤芳自赏	自惭形秽,曲学阿世
自惭形秽	自命不凡,厚颜无耻,孤芳自赏,自愧弗如
弛缓	紧张
经天纬地	才疏学浅
束手待毙	应付自如,垂死挣扎,困兽犹斗,死里逃生
困兽犹斗	放下屠刀,束手待毙,自行灭亡,束手就擒
鸣锣喝道	无声无息
仁至义尽	作威作福,以怨报德,漠不关心,惨绝人寰,惨无人道
漠不关心	息息相通,仁至义尽,嘘寒问暖,满腔热枕,无微不至,息息相关,关怀备至,各不相关,休戚相关,感同身受
通权达变	墨守成规
故	新
多灾多难	吉人天相
吉人天相	多灾多难,劫后余生,生不逢时,生不逢辰
牵强附会	天造地设
天造地设	牵强附会,矫柔造作
急如星火	慢条斯理,从容不迫
从容不迫	心急火燎,狼狈不堪,张皇失措,惊慌失措,手忙脚乱,惊魂未定,急如星火,面面相觑,仓皇失措
谴责	称赞,讥评,赞誉
赞誉	谴责
扶植	扼杀,推翻,铲除
铲除	保留,扶植
愚公移山	虎头蛇尾
心事重重	无忧无虑
拿手好戏	一无所能
一无所能	拿手好戏,胜任愉快
生财有道	投机倒把
投机倒把	生财有道,生财之道
著名	无名
志同道合	分道扬镳,貌合神离,道不同不相为谋
道不同不相为谋	志同道合
放任自流	防患未然
防患未然	临阵磨枪,放任自流,猝不及防
十恶不赦	罚不当罪
罚不当罪	十恶不赦,罪有应得
苦恼	高兴,快乐,甜美
时间	空间
空间	时间
忐忑不安	心烦意乱,泰然自若,心安理得,目瞪口呆
尾声	序幕,序曲
序幕	尾声
势如破竹	骑虎难下
骑虎难下	无往不利,势如破竹
失眠	入梦,安眠,入睡
安眠	失眠
废除	保留,施行,沿用,捣毁,实行,制订,建立
施行	废除
强人所难	心甘情愿,悉听尊便
大声疾呼	喁喁细语,默不做声
默不做声	大声疾呼,说三道四
恶毒	善良
善良	凶恶,毒辣,恶毒,阴险,丑恶,凶狠
事倍功半	一箭双雕,事半功倍
一箭双雕	事倍功半
豪情壮志	万念俱灰
万念俱灰	豪情壮志,雄心壮志,雄心勃勃,雄心未死,意气风发
似懂非懂	了如指掌
了如指掌	一团漆黑,似懂非懂,疑团莫释
若明若暗	一目了然
能工巧匠	酒囊饭袋
酒囊饭袋	能工巧匠
害处	利益,好处,益处
好处	害处,坏处,弊端
叶落归根	忘恩负义
忘恩负义	以直报怨,结草衔环,知恩报恩,感恩戴德,叶落归根
批评	表扬,褒扬
褒扬	贬抑,批评
瘠田	沃土
沃土	瘠田
警惕	麻痹
麻痹	留神,警觉,警惕
亲密无间	举目无亲,若即若离,誓不两立,视同陌路
举目无亲	亲密无间,形影相随
铁面无私	结党营私,徇情枉法
结党营私	铁面无私
干戈	玉帛
玉帛	干戈
耳熟能详	寡闻少见
寡闻少见	耳熟能详
阴谋诡计	光明正大
光明正大	阴谋诡计,偷鸡摸狗,鬼鬼祟祟,城狐社鼠,鬼头鬼脑
守	攻
攻	防,守
孜孜不倦	游手好闲,无心进取,四体不勤，五谷不分
四体不勤，五谷不分	不辞辛劳,孜孜不倦
玉碎	瓦全
瓦全	玉碎
急流勇退	知难而进,激流勇进,急流勇进
急流勇进	急流勇退,破釜沉舟
以身试法	以身作则
以身作则	以身试法
苟全性命	宁死不屈
宁死不屈	苟全性命,屈膝投降,屈打成招,苟延残喘
将	兵
兵	将,民,官
终点	尽头,起点
起点	终点
巧言令色	推心置腹
守正不阿	阿谀逢迎,徇情枉法
阿谀逢迎	守正不阿
可疑	可信,假伪
可信	可疑
门户开放	闭关自守,闭关锁国
纤小	粗大
粗大	纤小
约略	精确
精确	粗略,大略,大约,约略
倾囊相助	一毛不拔
一毛不拔	解囊相助,一掷千金,倾囊相助,慷慨好施,慷慨解囊
布衣	官绅
官绅	布衣
到达	出发,离去,起身,归宿
起身	到达
逐级	越级,破格
破格	逐级
长相厮守	人面桃花
人面桃花	长相厮守
照旧	更换,更动,更改
更换	照旧
落照	朝晖
朝晖	落照,夕照,残照
中庸之道	偏听偏信
偏听偏信	中庸之道
兴高采烈	没精打采,灰心丧气,垂头丧气,无精打采,郁郁不乐,万箭攒心,愁眉苦脸,冷水浇头
垂头丧气	昂首挺胸,额手称庆,兴高采烈,沾沾自喜,气宇轩昂,得意洋洋,高歌猛进,眉飞色舞
呆	活
败家子	守财奴
守财奴	败家子
瞻望	回顾
回顾	展望,瞻望
正言厉色	和颜悦色,谑浪调笑
和颜悦色	疾言厉色,横眉竖眼,正言厉色,金刚怒目,咄咄逼人,横眉立眼
恒产	动产
动产	恒产
天公地道	徇私舞弊
徇私舞弊	营私舞弊,公事公办,天公地道,大公无私
下井投石	乐善好施
如鱼得水	釜底游鱼
釜底游鱼	如鱼得水
变革	沿习,保守
保守	革新,泄露,激进,变革,渐进
新风	旧俗,陋俗,旧习
旧俗	新风
万古长存	遗臭万年
遗臭万年	流芳百世,永垂不朽,豹死留皮,名标青史,万古长存
落荒而逃	得胜回朝
得胜回朝	全军覆没,落荒而逃
天下太平	动荡不安,国无宁日,太平盖世,金戈铁马,天下大乱
天下大乱	天下太平
言归于好	话不投机
话不投机	言归于好,交浅言深,一拍即合
秀外慧中	贼眉贼眼
贼眉贼眼	秀外慧中
胆小怕事	初生牛犊不怕虎
初生牛犊不怕虎	胆小怕事
没	浮,有
民怨鼎沸	口碑载道
口碑载道	民怨鼎沸,啧有烦言,不得人心,人言可畏,怨声载道
愚笨	贤能,聪敏,聪明,乖巧
衣钵相传	以讹传讹
先生	学生
学生	老师,教师,先生,教授
月初	月终,月末,月底
月末	月初
内地	边疆,沿海,边陲
边陲	内地
不胫而走	秘而不宣
秘而不宣	不胫而走,据为己有,公诸同好,东窗事发
变量	常量,恒量
恒量	变量
愁眉锁眼	眉开眼笑,喜气洋洋
清夜扪心	执迷不悟
永垂不朽	遗臭万年
团	尖
尖	团
文治武功	文恬武嬉
文恬武嬉	文治武功
花好月圆	花残月缺
花残月缺	花好月圆
举世闻名	无声无臭
无声无臭	举世闻名
鼎盛	衰败
骨干	群众
群众	干部,领导,领袖,骨干
忠贞不渝	喜新厌旧,见异思迁,忠贞不二
见异思迁	矢志不渝,忠心耿耿,山盟海誓,忠贞不渝,二三其德,一心一意
诛求无已	两袖清风,廉政自守
两袖清风	诛求无已,宦囊饱满,贪得无厌
打退堂鼓	勇往直前
勇往直前	打退堂鼓,淡然处之,故步自封,裹足不进,望而却步,按部就班,畏葸不前,望风而逃,裹足不前,不进则退
言行不一	言行一致
藏龙卧虎	野无遗才,藏污纳垢
野无遗才	藏龙卧虎
具体而微	似是而非,硕大无朋
硕大无朋	具体而微,娇小玲珑,小巧玲珑
拖泥带水	删繁就简,惜墨如金,雷厉风行,干净利落,斩钉截铁,兔起鹘落,一刀两断
一刀两断	依依不舍,难解难分,千丝万缕,藕断丝连,纠缠不清,拖泥带水
吃斋	吃荤
吃荤	吃斋
力大无穷	黔驴技穷,黔驴之计
黔驴技穷	力大无穷,神通广大
急公近利	深谋远虑
深谋远虑	急公近利
龙吟虎啸	燕语莺声
燕语莺声	龙吟虎啸
无动于衷	震撼人心,潜移默化,扣人心弦,感人肺腑,触景生情,百感交集,情不自禁,感慨万千,睹物思人,金石为开,感慨系之
情不自禁	无动于衷
成心	无意
无意	有心,故意,成心,有意,存心
鄙薄	鄙视,重视
泪如泉涌	捧腹大笑,纵声大笑
纵声大笑	泪如泉涌
鲁莽	持重
持重	鲁莽
赫赫有名	无名英雄,默默无闻
无名英雄	赫赫有名
热带	寒带
寒带	热带
一往直前	瞻前顾后
扼要	累赘,啰嗦
累赘	扼要
负荆请罪	兴师问罪
兴师问罪	负荆请罪
先礼后兵	突然袭击
突然袭击	先礼后兵
上2	下
未可厚非	一无是处
一无是处	十全十美,未可厚非,尽善尽美
梗概	细节
细节	梗概
尖嘴猴腮	肥头大耳,风流潇洒
风流潇洒	尖嘴猴腮
涩	滑
滑	涩
还帐	借帐,欠帐
欠帐	还帐
腻烦	喜欢
平铺直叙	起伏跌宕,穷形尽相,抑扬顿挫,天花乱坠,生花妙笔
抑扬顿挫	波澜起伏,平铺直叙
疾言厉色	和颜悦色
乌合之众	如鸟兽散
如鸟兽散	乌合之众,云合雾散
以下	以上
以上	以下
全军覆没	得胜回朝,凯旋而归
过晌	头晌
头晌	过晌
乡间	城里
城里	乡间
充耳不闻	置若罔闻,洗耳恭听
洗耳恭听	充耳不闻
事先请示	先斩后奏
先斩后奏	事先请示
无事生非	安分守己
至少	至多
至多	至少
不堪造就	大器晚成,大有可为
大器晚成	初露锋芒,不堪造就
斤斤计较	鸡虫得失,大处着眼
鸡虫得失	斤斤计较,锱铢必较
全心全意	朝三暮四,坚忍不拔
朝三暮四	墨守成规,矢志不渝,全心全意
缩	胀,伸,涨
创业	守业
守业	创业
墨吏	清官
清官	墨吏,污吏,赃官
抱残守缺	革故鼎新,推陈出新
革故鼎新	抱残守缺,陈陈相因,泥古不化,因循守旧
花前月下	行同陌路
逃之夭夭	天罗地网,岿然不动
自作聪明	自知之明
自知之明	非分之想,自作聪明
跋山涉水	一路顺风
一路顺风	跋山涉水
贬	褒
褒	贬
地旷人稀	人烟稠密
人烟稠密	地旷人稀
黑糊糊	亮堂堂
亮堂堂	黑洞洞,黑糊糊,黑沉沉
偷工减料	精雕细刻,一丝不苟
难解难分	一刀两断
百折不挠	死灰复燃,因噎废食
因噎废食	百折不挠
三天打鱼，两天晒网	锲而不舍
洞察秋毫	浮光掠影
浮光掠影	入木三分,洞察秋毫
荆钗布裙	珠光宝气,珠围翠绕,凤冠霞帔
弱小	强大
增	减,损,删
删	增
见机而作	鲁莽行事
鲁莽行事	见机行事,见机而作,见几而作
锱铢必较	鸡虫得失,不拘小节
保障	侵犯
侵犯	保卫,保障
本末倒置	本末相顺
本末相顺	本末倒置
心灰意冷	信心百倍,雄心万丈
信心百倍	心灰意冷
有效	无效,作废
无效	有效,灵验,收效
受戒	破戒
破戒	受戒
拘泥	善变,灵活
熟手	生手
生手	老手,熟手
唯我独尊	虚己以听
虚己以听	唾面自乾,唯我独尊
顾盼自雄	目空一切,招兵买马
招兵买马	孤军作战,顾盼自雄
自是	虚心
虚心	自满,自是,自傲,自恃
普天同庆	哀鸿遍野,怨声载道
时不我待	得过且过
得过且过	再接再厉,时不我待
得势	失势
失势	得势
矢口否认	供认不讳
供认不讳	矢口否认
兴利除弊	陈陈相固,萧规曹随
萧规曹随	破旧立新,言出法随,兴利除弊
抛头露面	深居简出,隐姓埋名
摄政	亲政
亲政	摄政
情同陌路	夫唱妇随
夫唱妇随	情同陌路
保持	流失,改变
流失	保持
疾恶如仇	同流合污,助纣为虐
得而复失	转危为安,合浦还珠
转危为安	得而复失
胡言乱语	有凭有据,有条不紊
有凭有据	胡言乱语
不厌其烦	下不为例
过河拆桥	没身不忘,风雨同舟,结草衔环,没世不忘,饮水思源,枕戈泣血,知恩图报
饮水思源	数典忘祖,过河拆桥,得鱼忘筌
庸人	凡夫,天才
天才	捷才,庸人,蠢材,白痴
无地自容	理直气壮,恬不知耻
插翅难飞	轻而易举
颠扑不破	不攻自破,不堪一击
不攻自破	至当不移,颠扑不破
公道	偏心
偏心	公平,公道,持平
简明扼要	盘根错节,长篇累牍
盘根错节	简明扼要
华而不实	表里如一
表里如一	虚有其表,口是心非,朴实无华,华而不实,色厉内荏
添油加醋	实事求是
迎风	背风
背风	迎风
习以为常	大惊小怪,千载难逢,触目惊心,家常便饭
千载难逢	屡见不鲜,唾手可得,司空见惯,习以为常
隔岸观火	唇亡齿寒,见义勇为,身临其境
身临其境	扶危济困,隔岸观火
入选	落选
落选	考取,入选,当选
药到病除	无可救药,不可救药
无可救药	药到病除
促进	促退
促退	促进
一手包办	群策群力
不足	足够,过剩,充分,有余,已足,无厌
有余	不足
无足轻重	人命关天,举足轻重,燃眉之急
燃眉之急	不急之务,无关大局,无足轻重
喜不自胜	悲不自胜,怒形于色
怒形于色	喜不自胜
杞人忧天	若无其事,高枕无忧
若无其事	做贼心虚,杞人忧天
蔫巴	欢实
欢实	蔫巴
眼前	长远
长远	眼前,长久
愚不可及	大巧若拙
大巧若拙	愚不可及
人心惶惶	镇定自若,泰然自若
空荡荡	满登登
满登登	空荡荡
买空卖空	童叟无欺
童叟无欺	买空卖空,欺人太甚
老气横秋	生机勃勃,老骥伏枥,朝气蓬勃,老当益壮
朝气蓬勃	暮气沉沉,老气横秋,死气沉沉
模棱两可	旗帜鲜明,彰明较著
彰明较著	语焉不详,模棱两可
序言	后记,跋语
后记	引言,序言
万箭攒心	兴高采烈
垂涎三尺	视如敝屣,敝屣视之
山明水秀	穷山恶水
穷山恶水	鱼米之乡,山清水秀,山明水秀,山青水秀,名山大川,湖光山色
加剧	减轻
统销	统购
统购	统销
冷落	繁华,热闹,关心,落索,热情
目光如豆	目光如炬,高瞻远瞩
目光如炬	目光如豆
不明不白	一清二楚
一清二楚	不明不白,扑朔迷离
放下屠刀	困兽犹斗
无可比拟	不相上下,等量齐观
不相上下	并行不悖,天差地远,无可比拟,无与伦比
心中有数	胸中无数,心中无数
付出	收回,索取
索取	付出,捐献,退还,贡献,馈赠,赋予
久居故里	人去楼空
人去楼空	久居故里
探囊取物	缘木求鱼,海底捞针
缘木求鱼	探囊取物,海底捞针
公家	私人,公众
私人	公家
坦然自若	心惊胆战
心惊胆战	悠然自得,坦然自若,泰然自若
唉声叹气	豪言壮语
豪言壮语	唉声叹气
天诛地灭	天经地义
天经地义	似是而非,天诛地灭,荒谬绝伦
国无宁日	天下太平
历历可数	昏天黑地
昏天黑地	历历可数,历历在目,灯火辉煌
债台高筑	绰有余裕
绰有余裕	左支右绌,债台高筑
劳苦功高	徒劳无益
拐弯抹角	闪烁其辞,单刀直入,迂回曲折,直截了当,开门见山
单刀直入	旁敲侧击,拐弯抹角
纸上谈兵	身经百战
身经百战	坐而论道,纸上谈兵
同一	对立
对立	同一,统一
贻人口实	无瑕可击
无瑕可击	贻人口实
慢条斯理	匆匆忙忙,急如星火,慌里慌张,迫不及待,慢慢悠悠,急不可待,一日千里
格格不入	如影随形,得意忘言,情景交融,水乳交融
情景交融	格格不入
战天斗地	乐天知命
乐天知命	战天斗地
回	去
蜻蜓点水	下马看花,铺天盖地,下马观花
下马看花	走马观花,走马看花,蜻蜓点水
独当一面	俯仰由人,仰人鼻息
俯仰由人	独立自主,独当一面
不尴不尬	泰然自若
大有可为	无所作为,不堪造就
夺	送
奇耻大辱	丰功伟绩
丰功伟绩	弥天大罪,一得之功,奇耻大辱
一蹶不振	重整旗鼓,东山再起,死灰复然
东山再起	一蹶不振,冰消瓦解,息影园林
欢天喜地	愁眉苦脸,寻死觅活,苦海无边
苦海无边	欢乐无涯,欢天喜地
众志成城	众擎易举,一木难支,一盘散沙
一盘散沙	一统天下,众志成城,孤掌难鸣
湿漉漉	干巴巴
干巴巴	湿漉漉
停飞	放飞
放飞	停飞
沉冤莫白	平反昭雪
平反昭雪	降志辱身,沉冤莫白
欲言又止	指天画地
指天画地	欲言又止
新来乍到	故地重游
故地重游	新来乍到
预习	复习
复习	预习
节减	增加
增加	减削,节减,减少,削减
初出茅庐	老成持重,老谋深算,识途老马,久经世故
肥大	瘦小
瘦小	肥大,高大,敦实
纪律	自由
自由	奴隶,奴役,纪律
辗转	直接
直接	辗转,间接
完好无缺	残缺不全,东鳞西爪
残缺不全	完好无损,完好无缺
白手起家	根基深厚
根基深厚	白手起家
肃静	嘈杂
标	本
本	末,梢,标
糖衣炮弹	一尘不染
恰如其分	过甚其词,举措不当,过犹不及
举措不当	恰如其分
归纳	演绎
演绎	归纳
传宗接代	后继无人
后继无人	传宗接代,后继有人
俯首贴耳	作威作福,不卑不亢,桀骜不驯
不卑不亢	唯唯诺诺,俯首帖耳,俯首贴耳
无所不通	一窍不通
一窍不通	无所不知,无所不通,触类旁通,全知全能
气象万千	百孔千疮
百孔千疮	金无足赤,气象万千,完美无缺
乌七八糟	井然有序
井然有序	错综复杂,杂乱无章,杯盘狼藉,整齐划一,一塌糊涂,乌七八糟
最大公约数	最小公倍数
最小公倍数	最大公约数
生不逢时	吉人天相,福如东海,吉星高照,时来运转
凌乱	整齐
十室九空	安居乐业,地广人稀
耻辱	光彩,光荣,荣誉
光荣	羞辱,耻辱,可耻,名誉
千锤百炼	粗制滥造
随俗	超然
超然	随俗
铁树开花	触目皆是
触目皆是	铁树开花
闻鸡起舞	自暴自弃
自暴自弃	闻鸡起舞,自轻自贱,自高自大,自强不息
日暮途穷	前程万里,鹏程万里
前程万里	日暮途穷,死路一条,碌碌无为
减缩	扩展
扩展	简缩,减缩,紧缩
景慕	鄙夷
鄙夷	敬佩,景慕,敬慕
疲于奔命	优游自在,悠闲自得,以逸待劳
优游自在	疲于奔命,奔波劳碌
锐角	钝角
钝角	锐角
兴盛	衰落
污	清,净
解除	保留
保留	革除,废除,割除,解除,铲除,根除
劣	良,优
优	劣
脱靶	中靶
中靶	脱靶
胜任愉快	无能为力,一无所能
冻冰	开化
接触	隔绝,离开
不胜枚举	聊胜于无,屈指可数
寸草不生	郁郁葱葱,肥田沃土
郁郁葱葱	赤地千里,寸草不生
风起云涌	风流云散
风流云散	风起云涌
晋级	降级
降级	荣升,升级,晋级
肝胆相照	假人假义,尔虞我诈,明争暗斗,钩心斗角,沥胆披肝
酷热	凉爽,严寒
等量齐观	无可比拟,无与伦比
累牍连篇	片言只字,片纸只字
片言只字	累牍连篇,连篇累牍
兔起鹘落	拖泥带水
赶尽杀绝	慈悲为怀
慈悲为怀	赶尽杀绝
说和	挑拨
挑拨	撮弄,功和,调唆,说和
短命	长寿
长寿	夭折,短命,长命
广义	狭义
狭义	广义
低微	高亢
高亢	低微,低沉
不得而知	洞若观火
洞若观火	不得而知,雾里看花,管中窥豹,千头万绪,莫名其妙,莫明其妙,管窥蠡测
刚正不阿	阿谀奉迎,胁肩谄笑,阿谀奉承,官官相护,趋炎附势
官官相护	赏罚分明,刚正不阿
退避三舍	周旋到底,以眼还眼，以牙还牙,锋芒毕露
锋芒毕露	不露锋芒,退避三舍,不露圭角
翻天覆地	一成不变
首当其冲	畏缩不前
若隐若现	一目了然
循环往复	始终如一
始终如一	翻云覆雨,反复无常,出尔反尔,循环往复
水火不相容	水乳交融
水乳交融	若即若离,格格不入,水火不相容
胸襟坦荡	心怀叵测
心怀叵测	胸襟坦荡,光明磊落,襟怀坦白,正大光明
金碧辉煌	黯然无光
黯然无光	金碧辉煌
精兵猛将	老弱残兵
老弱残兵	精兵猛将
诗情画意	平淡无奇
乖巧	愚笨,淘气
呼幺喝六	低声下气
低声下气	呼幺喝六,气冲牛斗
公海	领海,内海
内海	公海
卖国	爱国
爱国	卖国
满腔热枕	漠不关心
烘云托月	开门见山
开门见山	转弯抹角,烘云托月,吞吞吐吐,拐弯抹角
轩然大波	风平浪静
流畅	晦涩,艰涩,生涩,枯涩
枯涩	流畅
人命关天	无足轻重
有口无心	言必有中
言必有中	有口无心,言不及义
明了	含混
含混	明了,明确
报仇雪恨	负屈含冤
负屈含冤	报仇雪恨
尸骨未寒	墓木已拱
墓木已拱	尸骨未寒
愁苦	欢乐
欢乐	忧愁,悲伤,悲苦,哀伤,悲凉,忧伤,惨切,悲哀,愁苦,哀痛
受宠若惊	麻木不仁
麻木不仁	受宠若惊,严阵以待,神经过敏
秋毫之末	重于泰山
重于泰山	秋毫之末,轻于鸿毛
血肉相连	不关痛痒
不关痛痒	血肉相连,唇齿相依
进步	落后,堕落,退步,落伍,反动
堕落	进步
巨细无遗	窥豹一斑
窥豹一斑	巨细无遗
进退两难	无往不利,得心应手
无往不利	骑虎难下,进退两难
腴	瘠
瘠	腴
任劳任怨	聊以塞责,怨天忧人
聊以塞责	任劳任怨,尽力而为
蝇营狗苟	光明磊落
无情	有情,多情,薄幸
轻徭薄赋	横征暴敛
横征暴敛	轻徭薄赋
年底	年初
海外奇谈	确凿不移
确凿不移	捕风捉影,海外奇谈
谋财害命	仗义疏财
迟	快
克勤克俭	挥霍无度
伤天害理	乐善好施,仰不愧天
细嫩	粗糙
月晕	日晕
日晕	月晕
前仆后继	贪生怕死
水磨工夫	操之过急
赞颂	批判
批判	表彰,赞颂
可想而知	不可思议
微观	宏观
宏观	微观
学以致用	学非所用,用非所学
学非所用	学以致用
遐迩闻名	默默无闻
死心塌地	犹豫不决,回心转意
放行	阻拦,阻挡,阻截
阻截	放行
胁肩谄笑	刚正不阿
纠缠不清	一刀两断
苦尽甘来	乐极生悲
乐极生悲	苦尽甘来,因祸得福,乐而忘返,及时行乐
围魏救赵	声东击西,围城打援
声东击西	围魏救赵
骄傲自满	不吝指教,谦虚谨慎
谦虚谨慎	忘其所以,趾高气扬,骄傲自满,狂妄自大
攀龙附凤	乐道安贫,视同路人
匠心独运	千篇一律,墨守成规
杀气腾腾	心慈手软
心慈手软	心狠手毒,杀气腾腾,心狠手辣
知过必改	明知故犯,将错就错
明知故犯	知过必改
不乏其人	寥寥无几,满坑满谷,屈指可数
寥寥无几	只影全无,不计其数,数不胜数,包罗万象,绝难一见,星罗棋布,不乏其人,人山人海,成千上万
容光焕发	面黄肌瘦,筋疲力尽
心服	口服
口服	心服
与日俱增	每况愈下
每况愈下	蒸蒸日上,再接再厉,盛极一时,有加无已,与日俱增
欺人太甚	童叟无欺
凡庸	杰出
美化	丑化
丑化	美化
后会有期	后会难期
后会难期	后会有期
艰苦朴素	骄奢淫逸,骄奢淫佚,穷奢极侈
穷奢极侈	枵腹从公,艰苦朴素
掩人耳目	众目昭彰
众目昭彰	掩人耳目
豪放不羁	畏首畏尾
望而却步	勇往直前
寄存	领取
领取	发放,支付,寄存,存放
无计可施	想方设法,机关算尽,急中生智
机关算尽	无计可施,束手无策
确实	虚假
虚假	真挚,确实,真确,不实,真实,诚实,真正
苦咧咧	甜丝丝,甜津津
甜津津	苦咧咧
小肚鸡肠	大度包容,网开一面
大度包容	小肚鸡肠,睚眦必报
恼羞成怒	心平气和
酸甜苦辣	四大皆空
四大皆空	七情六欲,酸甜苦辣
被动	被迫,主动,受动,能动
主动	被动
乐	愁,忧,哀
愁	喜,乐
父老兄弟	一官半职
一官半职	父老兄弟,黎民百姓
盖	开
淡泊寡味	垂涎欲滴,馋涎欲滴
馋涎欲滴	淡泊寡味
婀娜多姿	丑态百出
丑态百出	婀娜多姿
缓和	紧张,激化
声母	韵母
韵母	声母
和蔼	粗暴,蛮横,严厉
妒贤嫉能	知人善任
知人善任	妒贤嫉能
学富才高	学浅才疏
学浅才疏	学富才高
岂有此理	合情合理
释放	看押,收集,囚禁,监禁,拘押,收押,在押,禁锢,关押,捕获,发还,逮捕,拘捕
广开言路	拒谏饰非,闭目塞听
拒谏饰非	广开言路,闻过则喜
唯唯诺诺	强头倔脑,降龙伏虎,不卑不亢,俯首帖耳
强头倔脑	唯唯诺诺
未雨绸缪	临渴掘井,亡羊补牢
亡羊补牢	知错不改,未雨绸缪
妄自菲薄	妄自尊大,夜郎自大
向心力	离心力
离心力	向心力
空虚	充实,殷实,充满
充实	空虚
提	推
共同	独特,单独
单独	合伙,总共,结伴,寡少,共同,陪伴
日积月累	挥霍无度
满招损，谦受益	刚愎自用
云合雾散	如鸟兽散
事实	神话,谎言,假想,梦想,谣言,空言,传奇
谎言	事实
欢乐无涯	苦海无边
繁荣富强	民困国贫
民困国贫	繁荣富强
表	里
安居乐道	无妄之灾
无妄之灾	安居乐道,自取其祸
一相情愿	两相情愿
两相情愿	一厢情愿,一相情愿,大相径庭
根本	枝节
枝节	根本
大家闺秀	小家碧玉
小家碧玉	名门淑女,大家闺秀
匿名	具名
具名	匿名
活跃	沉闷
沉闷	活跃,舒畅
鸣金收兵	大动干戈
大动干戈	偃旗息鼓,鸣金收兵
盛世	乱世,衰世
乱世	盛世,太平,明世
同室操戈	同仇敌忾,自相残杀
同仇敌忾	同室操戈,亲痛仇快
致人死地	治病救人
治病救人	致人死地,落井下石
原原本本	有头无尾
有头无尾	虎头蛇尾,自始至终,原原本本,来龙去脉
津津有味	枯燥无味,索然无味,味同嚼蜡
索然无味	津津有味,耐人寻味,意味深长,百读不厌
自诉	公诉
公诉	自诉,指控
不同凡响	不过尔尔
不过尔尔	不同凡响
落日	旭日
旭日	朝日,落日
荣誉	耻辱,羞耻
百姓	官吏,国君
官吏	百姓
旁若无人	虚怀若谷,众目睽睽
众目睽睽	旁若无人
稀稀拉拉	密密麻麻,密密丛丛
密密麻麻	稀稀拉拉
隔靴搔痒	切中要害,一语破的,一针见血
一语破的	不可名状,隔靴搔痒
广	窄
闰年	平年
平年	闰年
预演	公演
公演	预演
再接再厉	每况愈下,得过且过
蹑足其闷	坐观成败
坐观成败	亲与其事,蹑足其闷
突变	渐变
渐变	突变
国富民强	国步艰难
乐此不疲	深以为苦,心不在焉
扬长而去	恋恋不舍
恋恋不舍	扬长而去,乐不思蜀
无关大局	举足轻重,燃眉之急
如影随形	格格不入
哀	乐
晨	昏
昏	晨
荤	素
素	荤,艳
金无足赤，人无完人	十全十美,完美无缺
十全十美	一无是处,美中不足,金无足赤，人无完人,一鳞半爪,白圭之玷
沃野千里	不毛之地,穷乡僻壤
农闲	农忙
农忙	农闲
顾影自怜	妄自尊大
提高	普及,降低,调低
大张旗鼓	消声匿迹,偃旗息鼓,重振旗鼓
偃旗息鼓	迎风招展,大动干戈,轰轰烈烈,大张旗鼓,卷土重来,重整旗鼓,兴师动众
沉没	漂浮
漂浮	沉没,扎实
痛心疾首	感恩戴德
感恩戴德	忘恩负义,痛心疾首,兔死狗烹
小年	大年
大年	小年
称赞	标谤,毁谤,讥讽,谴责,嘲讽
升涨	下跌
下跌	上涨,升涨
言简意赅	陈词滥调,鸿篇巨制
鸿篇巨制	片言之语,言简意赅
不明真相	洞烛其奸
洞烛其奸	不明真相,制造冤案
为所欲为	规行矩步,谨小慎微,安贫乐道
规行矩步	放浪形骸,别开生面,为所欲为,放荡不羁,不衫不履,肆无忌惮
销兵洗甲	剑拔弩张
剑拔弩张	销兵洗甲,绵里藏针
父系	母系
母系	赶怠,父系
七零八落	络绎不绝
络绎不绝	门可罗雀,七零八落
拆伙	合伙
合伙	单独,拆伙
轻车熟路	人生地疏
人生地疏	轻车熟路
少不更事	老成持重,少年老成
少年老成	少不更事
偏食	全食
全食	偏食
得意忘言	格格不入
恩深义厚	血债累累
血债累累	恩深义厚
深入浅出	隐晦曲折
隐晦曲折	深入浅出
外圆内方	外强中干,外方内圆
一误再误	知错改错
知错改错	一误再误
正式	暂行
暂行	正式
死不瞑目	心甘情愿,何乐不为
恭谨	轻狂
轻狂	恭谨
决断如流	优柔寡断
优柔寡断	当机立断,斩钉截铁,毅然决然,决断如流
小本经营	富可敌国
富可敌国	金玉满堂,身无长物,小本经营,家徒壁立,家徒四壁
走头无路	方便之门,柳暗花明
发昏	清醒
哀毁骨立	笑逐颜开
博学多才	不辨菽麦,大才盘盘,满腹珠玑,不学无术,满腹经纶,学富五车
不辨菽麦	博学多才,学富五车
否极泰来	福过灾生
福过灾生	否极泰来
速战速决	缓兵之计,旷日持久,指顾成功
缓兵之计	兵贵神速,速战速决
为渊驱鱼	损人利己
损人利己	为渊驱鱼,舍己救人,舍己为人
穷困	富裕,宽裕
对答如流	答非所问,无言以对
大书特书	轻描淡写,不在话下
轻描淡写	淋漓尽致,小题大做,语重心长,浓墨重彩,大书特书
奋起直追	踌躇不前
踌躇不前	毅然决断,奋起直追
拔寨起营	安营扎寨
安营扎寨	班师回朝,拔寨起营
循名责实	徒慕虚名,指鹿为马
徒慕虚名	循名责实
哗众取宠	实事求是
望洋兴叹	妄自尊大
立于不败之地	屡战屡败
梧鼠技穷	神通广大
神通广大	束手无策,黔驴技穷,梧鼠技穷
大张挞伐	和平共处
厚道	刻薄
刻薄	厚道,宽厚
负隅顽抗	束手就擒
束手就擒	困兽犹斗,负隅顽抗,绝处逢生
腰缠万贯	不名一钱,阮囊羞涩,一无长物,身无分文,囊空如洗
一无长物	腰缠万贯,应有尽有
从井救人	落井下石
啼饥号寒	丰衣足食,家给人足
地府	天堂
天堂	地府,地狱
生搬硬套	随机应变,相机行事
相机行事	妙手斲轮,生搬硬套
横生枝节	顺水推舟
顺水推舟	横生枝节
南柯一梦	如意算盘
如意算盘	南柯一梦
好过	难过,难受
令行禁止	温文尔雅,和风细雨
温文尔雅	移山倒海,令行禁止,喜怒无常,咄咄逼人,附庸风雅
清澈见底	污泥浊水
污泥浊水	清澈见底
三心二意	专心致志,聚精会神,心无二用
心无二用	魂不守舍,三心二意,一心二用
长年累月	一朝一夕
老生常谈	真知灼见
真知灼见	陈腔滥调,老生常谈,一得之见,一隅之见
百里挑一	残渣余孽
残渣余孽	百里挑一
奋不顾身	畏缩不前,视为畏途,贪生怕死
为虎作伥	劫富济贫
劫富济贫	为虎作伥,打家劫舍
不闻不问	不甘寂寞,明知故问
明知故问	不闻不问
结果	原因,开始,缘故,原由
原由	结果
赫赫名流	无名小卒
迷途知返	一意孤行,流连忘返,发人深省,执迷不悟
气味相投	针锋相对
煽风点火	息事宁人,排忧解难
排忧解难	煽风点火
济济一堂	分道扬镳,不欢而散
分道扬镳	萍水相逢,志同道合,携手合作,济济一堂,白头偕老,各奔前程
艰难	安适,容易
国营	私营
私营	国营,公营
安如磐石	摇摇欲坠,岿然不动,累卵之危
荣	辱,枯,耻
枯	荣
离题万里	字斟句酌
字斟句酌	望文生义,离题万里
内务	外交
外交	内务,内政
神采奕奕	无精打采,心力交瘁
启碇	抛锚
鬼	人,神
人	兽,神,鬼
走马观花	下马看花
急转直下	扶摇直上,扶摇直下,相持不一,相持不下
相持不下	急转直下
小巧玲珑	庞然大物,硕大无朋
庞然大物	娇小玲珑,小巧玲珑
贬低	吹捧,讥诮,抬高
抬高	贬低
野	朝
里应外合	孤军深入
孤军深入	里应外合
迷恋	厌倦,抛弃,贪恋,死心
抛弃	收留,拾取,搁置,迷恋
不堪回首	大喜过望,喜出望外
喜出望外	悲从中来,不堪回首,痛哭流涕
粉墨登场	匿影藏形,消声匿迹
信口雌黄	言之凿凿,三缄其口
言之凿凿	信口雌黄,无稽之谈
呶呶不休	沉默寡言
动如脱兔	静如处女
静如处女	动如脱兔
费事	省事
省事	费难,费事
惩前毖后	先来后到
先来后到	惩前毖后
如坐针毡	安之若素,泰然自若
恬不知耻	无地自容,汗颜无地
汗颜无地	恬不知耻
高昂	低落,低垂,低沉
低落	高昂,昂扬,高涨
休	戚
戚	休
计日程功	旷日持久
旷日持久	电光石火,计日程功,速战速决
守势	攻势
攻势	守势
反目成仇	相亲相爱,如胶如漆,如胶似漆,同舟共济,辅车相依,秦晋之好
如胶似漆	势同水火,反目成仇
争权夺利	淡泊明志
淡泊明志	争权夺利
前呼后拥	形单影只,轻装简从,轻车简从
昂首挺胸	垂头丧气,低眉顺眼
怯弱	勇敢
毛渠	干渠
干渠	毛渠,支渠
患难与共	貌合神离
貌合神离	志同道合,心心相印,患难与共,势合形离,齐心协力,心有灵犀一点通,抵足而眠
福如东海	时乖命骞,生不逢时
时乖命骞	福如东海
百废俱兴	百废不举
百废不举	百废俱兴
曲径通幽	繁华闹市
繁华闹市	曲径通幽
乖觉	愚蠢
侧目而视	目不斜视
目不斜视	左顾右盼,侧目而视
大相径庭	两相情愿,大同小异,异口同声
正路	邪路
邪路	正路
聚精会神	心不在焉,三心二意,魂不守舍
八斗之才	胸无点墨
撤防	设防
设防	撤防
委靡	抖擞,振作
晓畅	晦涩
标新立异	墨守成规,不甘落後,墨守陈规,步人後尘,陈陈相因
墨守陈规	标新立异,独辟蹊径
出笼	回笼
回笼	投放,出笼
片刻	良久
良久	俄顷,片刻,斯须,瞬息,转瞬
打破常规	清规戒律
清规戒律	陈规陋习,推陈出新,打破常规
似水流年	度日如年
精良	粗劣
粗劣	精良
弹尽粮绝	源源不断
源源不断	断断续续,弹尽粮绝
辩护	批驳
批驳	赞同,辩护
表露	掩盖
掩盖	揭露,隐藏,拆穿,暴露,吐露,声张,表露,揭穿
因陋就简	铺张浪费,富丽堂皇
富丽堂皇	寒微简陋,因陋就简,家贫如洗
一溃千里	旗开得胜
旗开得胜	一战即溃,一触即溃,一溃千里,四面楚歌
轻贱	高贵,宝重
高贵	低贱,卑贱,卑劣,微贱,下贱,轻贱
百读不厌	索然无味
一言九鼎	人微言轻
人微言轻	一言九鼎,一言千金
外姓	本家
本家	外姓
非分之想	自知之明
割除	保留
弄瓦	弄璋
弄璋	弄瓦
现实主义	浪漫主义
浪漫主义	现实主义
鹑衣百结	衣冠楚楚
衣冠楚楚	衣衫褴褛,不衫不履,鹑衣百结,不修边幅
删繁就简	拖泥带水,叠床架屋
发达	落后,潦倒,衰败
落后	进步,领先,发达,倒退
一命呜呼	长命百岁
长命百岁	一命呜呼
马到成功	头破血流,弃甲丢盔
弃甲丢盔	马到成功,所向披靡
适宜	失宜,不宜
失宜	适宜
富翁	穷人,贫民
穷人	富翁,财主
愁眉不展	怒容满面,颦眉蹙额,满面春风,喜逐颜开,喜笑颜开,喜形於色
满面春风	愁眉苦脸,愁眉不展
约数	确数
确数	约数
孙	祖
祖	孙
天衣无缝	漏洞百出,千疮百孔,破绽百出
千疮百孔	天衣无缝
羽翼已成	羽毛未丰
立功赎罪	罪上加罪
罪上加罪	立功赎罪
抚危济贫	趁火打劫
趁火打劫	济困扶危,抚危济贫,除暴安良,见义勇为,雪中送炭
奔走相告	呆若木鸡,面如土色
夫妻反目	百年之好
百年之好	破镜难圆,夫妻反目
正取	备取
备取	正取
管束	放纵
游刃有余	一筹莫展,捉襟见肘,进退维谷,智尽能索,勉为其难
一筹莫展	稳操胜券,大展宏图,游刃有余,锦囊妙计,情急智生,大显神通
纲	目
目	纲
芝兰之室	鲍鱼之肆
鲍鱼之肆	芝兰之室
铺张浪费	开源节流,因陋就简,节衣缩食,厉行节约
背阴	向阳
向阳	背阴
绵里藏针	剑拔弩张
开明	守旧,顽固
顽固	开明
浊泾清渭	是非不分
是非不分	浊泾清渭
孝子	逆子
逆子	孝子
从善如流	独断专行,一意孤行
迎风招展	偃旗息鼓
含蓄	露骨,浅露
浅露	含蓄
如臂使指	鞭长莫及,势成骑虎
势成骑虎	如臂使指
正中	旁边
旁边	正中
城狐社鼠	光明正大
垂帘听政	包而不办
包而不办	垂帘听政
东窗事发	秘而不宣
挑拨离间	排难解纷,精诚团结
精诚团结	分化瓦解,四分五裂,勾心斗角,明争暗斗,挑拨离间
罪大恶极	功德无量,功昭日月
功德无量	恶贯满盈,罪大恶极
心有灵犀一点通	貌合神离
善始善终	功亏一篑,有始无终
有始无终	善始善终,有始有终,持之以恒
着	熄,灭
灭	着
如狼似虎	菩萨心肠,如兄如弟
菩萨心肠	如狼似虎,蛇蝎心肠
持平之论	偏激之词,一孔之见
一孔之见	持平之论,见多识广
望风而逃	冲锋陷阵,勇往直前
郑重其事	满不在乎,掉以轻心
满不在乎	郑重其事
富余	缺少
缺少	富余,剩余
漆黑一团	光芒万丈
光芒万丈	漆黑一团
才高行洁	缺德少才,才疏学浅
劳师动众	按兵不动
按兵不动	劳师动众,雷厉风行,蠢蠢欲动,神出鬼没,倾巢而出,摩拳擦掌,出奇制胜,调兵遣将
麻痹大意	安不忘危,严阵以待
严阵以待	麻痹大意,麻木不仁
力所能及	力不胜任,力不能支,力不从心
力不能支	力所能及,力挽狂澜
鄙视	敬服,爱崇,鄙薄,亵渎,仰慕,崇拜,尊崇,重视,背弃,瞻仰,景仰
松软	坚硬,坚固,板结
水深火热	人寿年丰
人杰地灵	绸人广众,人稠物穰
绸人广众	人杰地灵
天网恢恢，疏而不漏	逍遥法外
逍遥法外	绳之以法,天网恢恢，疏而不漏,法网难逃,天网恢恢
辟谣	造谣
造谣	辟谣
充分	贫乏,不足
留用	革除
革除	保留,留用
豁达大度	偏狭小器,鼠肚鸡肠,心胸狭窄
鼠肚鸡肠	豁达大度
一拖再拖	当务之急
当务之急	一拖再拖,不急之务,迫在眉睫,遥遥无期
舜日尧天	豺狼当道
豺狼当道	舜日尧天
破旧立新	因循守旧,萧规曹随
材料	观点
观点	材料
偿还	借贷,拖欠
拖欠	偿还,清偿
知错不改	闻过则喜,亡羊补牢
闻过则喜	拒谏饰非,文过饰非,知错不改
三顾茅庐	拒人千里,妄自尊大
言之成理	妄下雌黄
妄下雌黄	言之成理,言必有据
管中窥豹	洞若观火,见多识广
气冲牛斗	低声下气
应运而生	生不逢辰
生不逢辰	应运而生,吉人天相
摇摆不定	坚韧不拔,坚忍不拔
坚韧不拔	动摇不定,摇摆不定
归并	分开
分开	连合,搅和,归并,合拢,结合,合并
秋高气爽	春雨绵绵
春雨绵绵	秋高气爽
自始至终	始终不渝,有头无尾
功臣	罪人
罪人	功臣
不期而遇	失之交臂
胡作非为	安分守己,安分守纪
人造	天然
天然	人造,人工
魂不守舍	聚精会神,心无二用
筑室道谋	一心一意
一心一意	心猿意马,三心两意,筑室道谋,见异思迁
战争	和平
和平	战争,暴力
迫不及待	待机而动,慢条斯理
待机而动	迫不及待
损害	减损,爱护,保护
坚强不屈	卑躬屈膝
卑躬屈膝	坚强不屈,不屈不挠,坚贞不屈,龙行虎步,大义凛然
忘掉	记住
记住	忘掉
清凉	燥热
燥热	清凉
战	和
和	战
百无聊赖	乐在其中,怡然自得
怡然自得	百无聊赖,局促不安,黯然销魂
初版	再版
再版	初版
瞠乎其后	并驾齐驱
一发千钧	稳如泰山
中断	赓续,延续,陆续,持续,继续
继续	中断,停止,罢休
退火	淬火
淬火	退火
放开手脚	缩手缩脚
缩手缩脚	不拘小节,放开手脚
不易之论	无稽之谈
无稽之谈	言之凿凿,不易之论,不容置疑,不刊之论
不急之务	当务之急,燃眉之急
高官厚禄	门可罗雀
门可罗雀	络绎不绝,客如云集,宾客如云,熙熙攘攘,高官厚禄,门堪罗雀,高朋满座,门庭冷落,宾客填门,门庭若市
勇挑重担	拈轻怕重
一言千金	人微言轻
战无不胜	每战皆北,一触即溃
一触即溃	戒备森严,旗开得胜,战无不胜,牢不可破,坚不可摧,举世无敌
夕阳西下	旭日东升
旭日东升	旭日初升,日薄西山,不可收拾,夕阳西下
量力而行	不自量力,眼高手低,力不从心
力不从心	力所能及,量力而行
公事公办	假公济私,大公无私,徇私舞弊
苟延残喘	宁死不屈,视死如归
栋梁之材	斗筲之材
斗筲之材	栋梁之材
以短击长	扬长避短
扬长避短	以短击长
空洞无物	微言大义
微言大义	空洞无物
摈弃	争取,吸取,斥逐
吸取	摈弃
虚构	写实
写实	虚构
死敌	死党,契友,至好,至交
契友	死敌
节约	浪费
畏葸不前	勇往直前,自告奋勇
全知全能	一窍不通
压迫	反抗
死灰复燃	百折不挠,销声匿迹
销声匿迹	死灰复燃,来势汹汹,出头露面,卷土重来,大事招摇
安安静静	天旋地转
天旋地转	安安静静
欲速不达	一蹴而就,瓜熟蒂落
瓜熟蒂落	欲速不达
极乐世界	不毛之地
不毛之地	沃野千里,极乐世界,鱼米之乡
末了	起头
起头	末尾,收尾,末了,扫尾
越级	逐级
矫揉造作	顺其自然,天真烂漫
天真烂漫	矫揉造作
生死与共	你死我活,自相鱼肉
自相鱼肉	生死与共
隐没	出现,显现
显现	消失,隐没,潜藏
大量	少许,少量
少许	大量
瑕瑜互见	白璧无瑕
萍踪浪迹	安家立业
安家立业	颠沛流离,安居乐业,无家无业,沦落风尘,萍踪浪迹
自得其乐	悲天悯人,自找苦吃,自作自受
悲天悯人	自得其乐,木人石心
相得益彰	欲盖弥彰
欲盖弥彰	文过饰非,相得益彰
蓄发	削发
削发	蓄发
流动	固定,冻结,凝滞
凝滞	结巴,灵活,流动
起用	免职
真情	假意
养痈成患	不留余地
不留余地	养痈遗患,养痈成患
大样	小样
小样	大样
震撼人心	无动于衷,静若秋水
长篇累牍	简明扼要,短小精悍
空空如也	满目琳琅,包罗万象,应有尽有
夜班	白班
白班	夜班
友爱	仇恨
仇恨	感激,友爱,恩惠,恩爱
同日而语	分门别类,较短论长
分门别类	同日而语
惊涛骇浪	风平浪静,风止波停
撒	收
收	撒,付,缴,发,送,播,种,支
肥	瘦
有口皆碑	众矢之的,怨声载道
主食	副食
副食	主食
新交	旧交,故人,故友
引咎自责	以邻为壑,作法自毙
以邻为壑	守望相助,不相为谋,引咎自责
资本主义	社会主义
社会主义	资本主义
洋洋洒洒	味同嚼蜡
味同嚼蜡	洋洋洒洒,易牙之味,其味无穷,妙趣横生,津津有味
以直报怨	忘恩负义
立足之地	无处容身
无处容身	立足之地
吸引力	推斥力
推斥力	吸引力
大恩大德	血海深仇,小恩小惠,新仇旧恨
新仇旧恨	大恩大德
斜纹	平纹
平纹	斜纹
年深日久	一朝一夕,瞬息之间
不容置疑	无稽之谈,荒诞不经
专制	民主,共和
民主	专政,集中,专制
顶	底
底	顶
残破	完好,完整
打草惊蛇	欲擒故纵
欲擒故纵	放虎归山,打草惊蛇
折本	盈利
不屈不挠	卑躬屈膝,奴颜婢膝
繁花似锦	残枝败柳
残枝败柳	繁花似锦
旁门	正门
正门	旁门,角门
敢想敢干	畏首畏尾,谨小慎微
甘心情愿	身不由己
身不由己	应付自如,甘心情愿
伯仲之间	天渊之别,天壤之别,霄壤之别
匆猝	从容
峰回路转	山穷水尽
缺吃少穿	丰衣足食
弃若敝屣	敝帚千金
敝帚千金	弃若敝屣
去火	上火
上火	去火
微型	大型
大型	微型
物极必反	千篇一律
坐商	行商
行商	坐商
白驹过隙	度日如年
舍己为人	自私自利,挑肥拣瘦,损人利己,杀人越货
高明	低劣,拙劣
强硬	和缓,软弱
和缓	强硬,锋利
复圆	初亏
初亏	复圆
热烈	平静
抵制	贯彻,助长,支持
支持	抵制,反对,反驳
屈	直
再生父母	切骨之仇
切骨之仇	再生父母
酒肉朋友	布衣之交,金兰之契,患难之交
患难之交	泛泛之交,酒肉朋友,深厚之交
别开生面	规行矩步,述而不作,家常便饭
家常便饭	别开生面,习以为常,山珍海味
空口无凭	铁证如山,立此存照
铁证如山	空口无凭
达官	平民
平民	贵族,达官
令人齿冷	肃然起敬
西历	农历
称誉	申斥
申斥	称誉
秘密	公开
公开	私下,暗地,暗藏,隐秘,秘密,隐蔽
惊魂未定	从容不迫
泥沙俱下	去伪存真,沙里淘金
去伪存真	鱼龙混杂,泥沙俱下
岁月蹉跎	马不停蹄
马不停蹄	停滞不前,岁月蹉跎,虚度光阴
一介不取	一网打尽
一网打尽	一介不取
素雅	俗气
俗气	雅致,素雅
先锋	后卫
后卫	先锋,前卫
变本加厉	大题小作,微不足道
大题小作	变本加厉,小题大作,借题发挥
耗费	节省
削职为民	走马上任
走马上任	削职为民
轻视	尊重,珍视,注重,重视
散失	收藏
收藏	散失
激进	保守
偷香窃玉	安分守己
明察暗访	不见薪新
不见薪新	明察暗访
开源节流	铺张浪费
自负	自卑,谦虚
拨乱反正	离经背道,积重难返
积重难返	拨乱反正,死不改悔,痛改前非
饥寒交迫	金迷纸醉,丰衣足食,人寿年丰,暖衣饱食
滋生	灭绝
灭绝	滋生
见怪不怪	惊心动魄,少见多怪
惊心动魄	召梦催眠,见怪不怪
欲壑难填	一尘不染
画蛇添足	歪打正着,弄假成真
歪打正着	画蛇添足
不辞而别	不速之客
不速之客	不辞而别
宝	废
废	宝
围城打援	围魏救赵
七拼八凑	无懈可击
胡说八道	言之有据,不见经传
言之有据	出何典记,胡说八道
领先	落后
势不两立	情同骨肉,三位一体,并行不悖,并存不悖
并行不悖	势不两立,不相上下,大相迳庭
头重脚轻	根深蒂固
根深蒂固	摇摇欲坠,头重脚轻
悲剧	喜剧
喜剧	悲剧
年轻力壮	年老力衰
年老力衰	年轻力壮
空谈快意	现身说法
现身说法	空谈快意
喜笑颜开	愁眉不展,愁肠百结
愁肠百结	喜笑颜开,洋洋得意,沾沾自喜
守节	坚贞,失节变节再醮,变节,失节
失节	守节
兴奋	镇静,忧愁,抑制,沮丧
补偿	消耗,损耗
损耗	增添,积蓄,补偿
平行	交叉
交叉	平行
概括	具体
的了吗呢	之乎者也
之乎者也	的了吗呢
游手好闲	一馈十起,夙兴夜寐,孜孜不倦,埋头苦干
刮目相看	横加白眼,置之不理
置之不理	另眼相看,却之不恭,刮目相看
鸦默雀静	沸反盈天
沸反盈天	鸦默雀静,鸦雀无声
羞怯	大方
诅咒	祝福,歌颂,颂扬
颂扬	咒骂,诅咒,诽谤
不成体统	循规蹈矩
循规蹈矩	离经叛道,谋为不轨,不成体统,横行无忌,任其自然,尊孔崇儒,惹是生非,随心所欲,谋图不轨
迫在眉睫	当务之急,远在天边
远在天边	近在眼前,迫在眉睫,近在眉睫
固体	流体,液体
流体	固体
冷锋	暖锋
暖锋	冷锋
支出	收入
收入	收纳,支出
叠床架屋	删繁就简,精兵简政
原告	被告
被告	原告
平缓	险峻,陡峭,峭拔
峭拔	平缓
雄厚	薄弱,微薄
薄弱	雄厚,强大,坚实
见利思义	轻财仗义,见利忘义,利令智昏
利令智昏	见利思义,见利忘义
有勇无谋	有勇有谋,大智大勇,智勇双全
有勇有谋	勇而无谋,有勇无谋
雨季	旱季
旱季	雨季
扶	抑
抑	扶,扬
动工	竣工
竣工	动土,施工,动工
锦上添花	雪上加霜,雪中送炭,佛头着粪
开诚布公	掩耳盗铃,明枪暗箭,尔虞我诈
万事亨通	艰难曲折,时乖命蹇,焦头烂额,荆棘载途,内外交困
时乖命蹇	万事亨通,加官进爵,吉祥如意
鬼头鬼脑	光明正大,堂堂正正
堂堂正正	鬼头鬼脑
播种	收获
收获	播种
莫名其妙	恍然如悟,洞若观火
前脚	后脚
后脚	前脚
狭路相逢	风云际会
风云际会	冤家路窄,狭路相逢
低沉	高昂,激昂,高亢,不振,昂扬,激越,明朗
闹嚷嚷	静悄悄
静悄悄	闹哄哄,闹嚷嚷
出超	入超
入超	出超
干巴	水灵
水灵	干巴,干枯
持久战	速决战
速决战	持久战
视为畏途	奋不顾身
乐音	噪音
噪音	乐音
里通外国	大义灭亲
大义灭亲	徇情枉法,认贼作父,里通外国
就地取材	他山之石
他山之石	就地取材
盛极一时	每况愈下,一落千丈
暮霭	晨曦
晨曦	夕照,暮霭,朝晨
冷气	暖气热气,暖气
暖气	冷气,凉气
丧心病狂	平心静气
平心静气	丧心病狂,气急败坏,大发雷霆
孤立无援	一呼百诺
享乐	吃苦
吃苦	享福,享乐,享受
一年生	多年生
多年生	一年生
楚楚可怜	望而生畏
望而生畏	挺身而出,楚楚可怜
冰消瓦解	重起炉灶,东山再起
放晴	转阴
转阴	放晴
租	佃
佃	租
独树一帜	如法炮制
如法炮制	独树一帜,独出心裁,别具匠心
束之高阁	掌上明珠,爱不释手
掌上明珠	束之高阁
八拜之交	一日之雅
一日之雅	八拜之交
离	即,合,就
就	离
幽	明
脱口而出	守口如瓶
守口如瓶	脱口而出,口若悬河,漏泄春光,说东道西,信口开河,冲口而出
人间	地狱
地狱	人间,天堂
锦绣前程	穷途末路
穷途末路	四通八达,锦绣前程,方兴未艾,柳暗花明
龙行虎步	卑躬屈膝,低三下四
低三下四	高人一等,龙行虎步,不亢不卑
一统天下	一盘散沙
拙见	高论,高见
高见	的论,拙见,管见
留	去
落网	漏网,潜逃
潜逃	落网
落叶归根	乐不思蜀
乐不思蜀	安不忘危,归心似箭,恋恋不舍,落叶归根
若有所失	聊以自慰,不动声色,自我陶醉,煞有介事
真话	谣言,谎话
谎话	真话
慌里慌张	慢条斯理
排泄	吸收,剔除
吸收	屏弃,排泄
陡坡	慢坡
慢坡	陡坡
肤皮潦草	严肃认真
严肃认真	肤皮潦草
东鳞西爪	包罗万象,完好无缺
尽职	失职
失职	尽职
下贱	高贵
复学	休学,停学
休学	复学
身陷囹圄	重见天日
重见天日	不见天日,身陷囹圄,暗无天日
不经之谈	不刊之论
不刊之论	不经之谈,无稽之谈
米珠薪桂	物美价廉
物美价廉	米珠薪桂
获得	失却,得回,丧失,失去
失去	获得,取得
沿袭	改革
改革	守旧,沿袭,因袭
猝不及防	防患未然
婉转	直爽,直率
直率	婉转
黎民百姓	一官半职
意味深长	索然无味
实质	现象
现象	实质,本质
东倒西歪	井井有条
井井有条	语无伦次,乱七八糟,污七八糟,颠三倒四,杂乱无章,东倒西歪,百废待举,纵横交错
俄顷	良久
手足之情	视同陌路
视同陌路	亲密无间,手足之情
故弄玄虚	实事求是
无凭无据	信而有征
信而有征	无凭无据,信口开河
暗码	明码
明码	暗号,暗码
全力以赴	敷衍了事
石沉大海	一封家书
一封家书	石沉大海
不堪一击	坚如磐石,攻无不克,壁垒森严,无坚不摧,固若金汤,举世无敌,颠扑不破
奥妙无穷	一定之规
以强凌弱	抑强扶弱,除暴安良,锄强扶弱
不在话下	鞭长莫及,大书特书
江郎才尽	七步成诗,下笔成章
下笔成章	江郎才尽
屈打成招	宁死不屈,铁案如山,不打自招
缠身	脱身
脱身	缠身
功	过,罪
过	功
马革裹尸	临阵脱逃
临阵脱逃	临危不惧,前赴后继,当仁不让,马革裹尸,冲锋陷阵
安稳	动荡,焦躁,危急
知情达理	胡搅蛮缠
胡搅蛮缠	知情达理
开荤	吃素
吃素	开荤
慈善	歹毒,凶恶
横行霸道	安分守己,打躬作揖
和好	翻脸,交好,争吵,交恶,反目
反目	和好,联谊
勉为其难	游刃有余
保密	失密,泄密
泄密	保密
仰视观察	盲人摸象
盲人摸象	仰视观察
众口交谪	拍案叫绝
拍案叫绝	嗤之以鼻,众口交谪
凤冠霞帔	荆钗布裙
青梅竹马	背信弃义
背信弃义	骨肉相连,恪守不渝,青梅竹马,一诺千金
出现	消失,隐匿,隐没,消逝,湮灭,崭露
潜	浮
席丰履厚	餐风露宿
废弃	储存,利用,使用
使用	储备,废弃
三长两短	安然无恙
安然无恙	三长两短,朝不保夕,祸在燃眉,四面楚歌,山高水低,千钧一发
靠天吃饭	人定胜天
人定胜天	靠天吃饭
良师益友	一丘之貉,狐群狗党
一丘之貉	黑白分明,良师益友,比众不同,意气相投
方寸已乱	心安理得
四平八稳	操之过急,如饥似渴,想入非非,轻举妄动
扶老携幼	奸淫掳掠
奸淫掳掠	扶老携幼,尊老爱幼,秋毫无犯
旰食宵衣	好逸恶劳
静止	活动,飘动,震动,遨游,摇曳,运动,滚动,飘荡,涟漪,奔腾
运动	静止
富足	贫乏
特意	顺便
顺便	特意,乘便,专门,特地,专程
横行无忌	安分守己,循规蹈矩
生灵涂炭	国泰民安
三纲五常	离经叛道
离经叛道	三纲五常,循规蹈矩
食肉寝皮	情深义重
情深义重	食肉寝皮
手舞足蹈	闷闷不乐
闷闷不乐	喜形于色,怏怏不乐,心花怒放,手舞足蹈
搜索枯肠	文思泉涌,无所用心
对口	单口
单口	对口
俊	丑
始终不懈	虎头蛇尾
各自为政	顾全大局,同心协力
同心协力	各行其是,分庭抗礼,各自为政
以貌取人	量材录用,任人唯贤
任人唯贤	以貌取人
沉寂	喧闹,喧嚣
非分	本分
本分	非分
是非分明	青红皂白,不问青红皂白,不分皁白
不问青红皂白	是非分明,泾渭分明
浮动	固定
敬佩	鄙夷
取信	失信
液体	固体
人山人海	寥寥无几,孤灯只影,人迹罕至
廉洁奉公	贪赃枉法,假公济私,寡廉鲜耻,无耻之尤
寡廉鲜耻	卑鄙无耻,廉洁奉公,光明磊落
挨肩擦背	敬而远之
敬而远之	挨肩擦背,相敬如宾,咄咄逼人
沉陷	突起
突起	洼陷,沉陷
投机取巧	正人君子
犹疑	坚定
荼毒	爱护
爱护	荼毒,戕害,损害,践踏,破坏
坚不可摧	岿然不动,摧枯拉朽,毁于一旦,一触即溃
往日	来日
来日	往日,昔日
扩充	裁并,缩减
裁并	扩充
不辞辛劳	摩顶放踵,四体不勤，五谷不分
直爽	婉转
防守	攻打,攻击,进攻
攻打	防守
亘古不变	瞬息万变
瞬息万变	亘古不变
崇拜	鄙视,蔑视
原文	译文
译文	原文
偶然	必然,一贯,不常
必然	或然,偶然
脱颖而出	怀才不遇
怀才不遇	脱颖而出,蛟龙得水,丹凤朝阳
本来面目	耸人听闻,乔装打扮,涂脂抹粉,装模作样,面目全非
耸人听闻	本来面目,不偏不倚
出言不逊	温柔敦厚,谦厚有礼,卑辞厚礼
谦厚有礼	出言不逊,出口伤人
群威群胆	孤家寡人
孤家寡人	群威群胆
颠簸	平稳
平稳	颠簸,激烈
冲动	冷静
冷静	闹热,暴躁,亢奋,冲动,狂热,激动,焦虑
视而不见	过目不忘
过目不忘	视而不见
平安无事	狼烟四起
狼烟四起	平安无事,国泰民安
三思而行	冒昧从事,不假思索
不假思索	左思右想,深思熟虑,三思而行
丧权辱国	光宗耀祖
光宗耀祖	丧权辱国,羞辱门楣
湖光山色	穷山恶水
丰裕	贫困
贫困	丰裕,富有,富裕
当世无双	无独有偶
无独有偶	举世无双,独一无二,当世无双
得寸进尺	进寸退尺,心满意足,适可而止,知足不辱
排遣	郁结
郁结	排遣
才气过人	才疏学浅
因势利导	听之任之,听其自然
听之任之	因势利导
潜移默化	无动于衷
徒有虚名	名不虚传
名不虚传	徒有虚名,有名无实
秀色可餐	其貌不扬
残害	保护
斯文扫地	冠盖高举,显亲扬名
显亲扬名	斯文扫地
愁容	笑容,喜色
笑容	愁容
召回	派遣,差遣
派遣	撤回,调回,召回
力图	力避
力避	力图,力求,力争
自觉自愿	逼上梁山
逼上梁山	自觉自愿
覆灭	崛起,胜利,生还
生还	遇难,覆灭
结草衔环	忘恩负义,过河拆桥
励精图治	纵逸酣嬉,祸国殃民
祸国殃民	治国安民,忧国忧民,安邦定国,励精图治,成仁取义
口若悬河	噤若寒蝉,守口如瓶,钳口不言,金人缄口
自私自利	毁家纾难,舍己为人,公耳忘私,公而忘私,大公无私,损人利已
毁家纾难	自私自利
无所顾忌	畏首畏尾
阳历	阴历
阴历	阳历
成事	败事
败事	成事
扫尾	起头
外子	内子
内子	外子
忧愁	孤癖,欢乐,快乐,兴奋,快活
大同小异	云泥之别,天差地远,绝不相同,大相径庭,天渊之别
兢兢业业	敷衍了事,草草了事,马马虎虎
空手而回	满载而归
遵从	违反,违背
不可逾越	后来居上
后来居上	不可企及,望尘莫及,不可逾越
玩忽职守	以身殉职,克尽厥职
克尽厥职	玩忽职守
收复	割让,陷落,沦丧
沦丧	收复
惊慌	镇静,沉着,镇定
沉着	惊慌,仓皇,浮躁,慌张,急躁
匪伊朝夕	一朝一夕
理所当然	荒谬绝伦
荒谬绝伦	天经地义,理所当然
赤地千里	郁郁葱葱,蓊蓊郁郁
色彩单一	五颜六色,五光十色
五颜六色	色彩单一
言必有据	妄下雌黄
便利	麻烦
荷枪实弹	手无寸铁,赤手空拳
赤手空拳	荷枪实弹,全副武装,兵强马壮,坚甲利兵
有害	有用,无益,有益
有用	有害,无用
车载斗量	太仓一粟,寥若晨星
寥若晨星	星罗棋布,层出不穷,车载斗量,浩如烟海
噩耗	佳音,喜讯
佳音	噩耗
却之不恭	置之不理
放诞	检点
凯旋	败北
败北	凯旋,胜仗,胜利,获胜
眉清目秀	面目可憎,披头散发,獐头鼠目,蛇头鼠眼,蓬头垢面
匕鬯不惊	兵匪不分
兵匪不分	匕鬯不惊
俯拾即是	千载一时,凤毛麟角
凤毛麟角	多如牛毛,漫山遍野,俯拾即是
养兵	用兵
用兵	养兵
反复无常	一去不复返,始终如一
一去不复返	反复无常
众	寡
寡	众
啧有烦言	交口称誉,口碑载道,众口交誉
烜赫一时	彪炳千古
彪炳千古	烜赫一时
卓见	远瞩,浅见,明见
浅见	卓见
执拗	随和
随和	乖僻,严肃,执拗,孤僻
小处着手	大处着眼
大处着眼	斤斤计较,小处着手
贫瘠	丰饶,膏腴,肥沃
肥沃	贫瘠,枯瘠,瘠薄
赏罚不当	赏罚分明
赏罚分明	赏罚不明,官官相护,赏罚不当
不露锋芒	锋芒毕露
绿林好汉	打家劫舍
打家劫舍	道不拾遗,绿林好汉,劫富济贫
千钧一发	安然无恙
离心离德	和衷共济,同心同德
同心同德	同床异梦,离心离德,各怀鬼胎,协力同心
强弩之末	势不可挡
势不可挡	强弩之末
改头换面	原封不动,庐山真面目
庐山真面目	改头换面
粗略	详尽,详细,周详,精确
难于登天	易如反掌,举手之劳
易如反掌	难如登天,难于登天
一丝一毫	成千累万
成千累万	九牛一毛,一丝一毫
齐心协力	貌合神离
气馁	骄傲
文过饰非	欲盖弥彰,闻过则喜
指挥若定	心中无数
和风细雨	急风暴雨,劈头盖脸,令行禁止,凄风苦雨,暴风骤雨
厚此薄彼	一视同仁
一视同仁	厚此薄彼,因材施教,量才录用,不分畛域
荣华富贵	倾家荡产
倾家荡产	成家立业,发家致富,荣华富贵
谙练	生疏
骄慢	谦虚
夙兴夜寐	饱食终日,游手好闲
冷酷无情	儿女情长
儿女情长	冷酷无情,英雄气短
目迷五色	明察秋毫
明察秋毫	目迷五色
毅然决然	优柔寡断
不省人事	通情达理
通情达理	不近人情,不省人事
贫穷	富有,富裕,宽裕,富庶,富饶
富饶	贫乏,枯窘,贫穷
丰盛	匮缺,短缺,匮乏
短缺	余剩,周全,充足,丰盛
销帐	上帐,入帐
上帐	销帐
枯燥无味	津津有味,耐人寻味,妙趣横生
耐人寻味	枯燥无味,索然无味
例行公事	别出心裁
别出心裁	依样葫芦,例行公事
沽名钓誉	实至名归
实至名归	沽名钓誉
合并	分头,分离,分开,划分
划分	合并
荒地	熟地
熟地	荒地,生地
无家无业	安家立业
别有风味	如出一辙
如出一辙	不拘一格,别有风味,形形色色,别辟蹊径
看押	释放
典雅	粗俗
粗俗	文雅,雅致,高雅,卑俗,典雅
亏空	结余,节余
结余	超支,亏空
奖	惩
惩	奖
孤陋寡闻	知多见广,博古通今,博闻见广,寡见少闻,见闻广博,见多识广
知多见广	孤陋寡闻
对牛弹琴	对症下药,有的放矢
对症下药	无的放矢,对牛弹琴
赎身	卖身
卖身	赎身
皂	白
博大精深	以蠡测海
以蠡测海	博大精深,兼收并蓄
威风凛凛	文质彬彬
信手拈来	来之不易,大海捞针
炫玉贾石	心口如一
心口如一	口是心非,炫玉贾石,八面玲珑,阳奉阴违
死路一条	前程万里
三位一体	势不两立
粪土	瑰宝
瑰宝	粪土
弱不禁风	身强力壮,虎背熊腰,心宽体胖
一暴十寒	持之以恒,锲而不舍
明眸皓齿	青面獠牙
下限	上限
上限	下限
遥遥相对	互不相干,毫无瓜葛
毫无瓜葛	遥遥相对
锐不可当	损兵折将
损兵折将	锐不可当
晴	阴
纳降	投降
投降	受降,抵抗,招架,纳降
无理取闹	据理力争,不由分说
据理力争	无理取闹,忍气吞声
权门	寒门
寒门	权门,望族,朱门
爱好	厌恶
风马牛不相及	唇齿相依
唇齿相依	风马牛不相及,不关痛痒
全面	片面
片面	双方,全面
超然物外	投身其中,与世浮沉,随波逐流
随波逐流	推波助澜,中流砥柱,超然物外
忧	乐
天翻地覆	一成不变
老翁	少年
少年	童年,老翁
侵占	退赔
势如冰炭	情同手足
情同手足	势如冰炭
兼容并包	爬梳剔抉
爬梳剔抉	兼容并包
郊区	城市,城区
城市	乡村,郊区,农村,乡下
剩余	缺少
小心谨慎	矜才使气,谨小慎微,粗心大意
淡忘	萦思,惦记
惦记	淡忘
甘居下游	力争上游
力争上游	自甘堕落,甘居人后,甘居下游
详细	大体,简单,概况,大概,粗略,简略,简要
简略	详实,详尽,详细
难能可贵	不足为奇
次要	主要,辅助,首要
主要	紧要,次要
流食	普食
普食	流食
一曝十寒	好学不倦,半途而废
好学不倦	一曝十寒
自转	公转
公转	自转
背叛	归顺,归降
归降	背叛
离休	在职
在职	退休,离职,离休
劳而无功	行之有效
长此以往	一时半刻
一时半刻	长此以往
揭竿而起	忍辱偷生
忍辱偷生	揭竿而起
一无所得	无功受禄
穷形尽相	平铺直叙
竹头木屑	奇珍异宝
奇珍异宝	竹头木屑
变化无穷	原封不动,一成不变
原封不动	变化无穷,改头换面
朝秦暮楚	一往情深,始终不渝,忠心赤胆
鼠目寸光	高瞻远瞩,大开眼界,鉴往知来
大开眼界	鼠目寸光
金蝉脱壳	瓮中捉鳖
瓮中捉鳖	金蝉脱壳,水中捞月
乘虚而入	无懈可击,无隙可乘
无隙可乘	有机可乘,有隙可乘,可乘之机,乘虚而入
点金成铁	点铁成金
点铁成金	点金成铁
一知半解	通今博古,打破沙锅问到底
打破沙锅问到底	一知半解
徒劳无功	水到渠成,不劳而获,一本万利
不劳而获	自食其力,徒劳无功
大名鼎鼎	无名鼠辈,臭名昭著
无名鼠辈	德高望重,大名鼎鼎
豹死留皮	遗臭万年
欺贫爱富	惜老怜贫
惜老怜贫	欺贫爱富,嫌贫爱富
将来	夙昔,过去
过去	将来,未来
发家致富	倾家荡产
稳操胜券	一筹莫展
天涯海角	一箭之遥,咫尺之间,近在咫尺
近在咫尺	天涯海角,地角天涯,咫尺天涯,山南海北,不远千里,天各一方,关山迢递
重起炉灶	冰消瓦解
少安毋躁	心急如焚
心急如焚	少安毋躁
怨气冲天	心平气和
愤时嫉俗	随遇而安
随遇而安	愤愤不平,愤时嫉俗
作	息
息	作
称心如意	事与愿违,大失所望
大失所望	称心如意,正中下怀,尽如人意,差强人意,大喜过望
三人成虎	眼见为实
眼见为实	三人成虎
兴师	回师
回师	兴师,出师
失散	团圆,欢聚
团圆	失散,离散
后继有人	接二连三,后继无人,青黄不接,后继乏人
接二连三	后继有人
杀身成仁	苟且偷生
苟且偷生	杀身成仁,舍生取义,成仁取义
唾手可得	千载难逢
神	人,鬼,形
形	神
有始有终	虎头蛇尾,有始无终
相敬如宾	敬而远之,绝情反目
寒来暑往	度日如年
管窥蠡测	纵观全局,洞若观火
闭口不言	振振有词,畅所欲言
畅所欲言	吞吞吐吐,闭口不言
暗送秋波	明目张胆
明目张胆	暗渡陈仓,明火执仗,暗送秋波,堂堂皇皇,偷偷摸摸
名声扫地	身价百倍
身价百倍	名声扫地
呆头呆脑	乖巧伶俐,七步之才,眼明手快,聪明伶俐
眼明手快	呆头呆脑
今不如昔	今非昔比,昔不如今
今非昔比	依然如旧,今不如昔
低眉顺眼	昂首挺胸
乱成一团	丝丝入扣
行家	外行
外行	懂行,行家,内行
万籁俱寂	熙来攘往,震耳欲聋,天崩地裂,声振林木,惊天动地,锣鼓喧天
震耳欲聋	鸦雀无声,万籁无声,万籁俱寂
破旧	崭新,古旧
卑鄙无耻	高风亮节,寡廉鲜耻,高风峻节
高风亮节	卑鄙无耻,伤风败俗,卑鄙龌龊
久经世故	初出茅庐
真率	做作
做作	真实,自然,真率
同归于尽	贪生怕死
领受	谢绝,拜领,给与
谢绝	领受
皆大欢喜	怨声载道
骄阳似火	天寒地冻
天寒地冻	骄阳似火,春暖花开,春色满园,赤日炎炎
许愿	还愿,兑现
还愿	许愿
延长	缩短
缩短	延长,拉长
水涨船高	一成不变
徒手	持械
持械	徒手
云消雾散	云笼雾锁
云笼雾锁	云消雾散
苍白	红润,黑瘦,黎黑
红润	苍白,黑瘦,惨白
相亲相爱	反目成仇
养痈贻患	养军千日，用在一时,斩草除根
养军千日，用在一时	养痈贻患
自强不息	自暴自弃,自轻自贱
自轻自贱	自暴自弃,自高自大,自强不息
人言可畏	口碑载道
见贤思齐	争风吃醋
争风吃醋	男欢女爱,见贤思齐
世态炎凉	一如既往
陪音	基音
基音	陪音
皈依	脱离
竭泽而渔	从长计议
哭笑不得	泰然处之
泰然处之	寝食不安,哭笑不得,神思恍惚
牵强	贴切
贴切	牵强
养痈遗患	不留余地
惊天动地	无声无息,不知不觉,万籁俱寂
举世无双	无独有偶
险峻	平缓
毫无疑义	满腹疑团,大有可疑
满腹疑团	毫无疑义
单干	合作
合作	分工,单干
忍辱负重	忍无可忍
抵达	起程
起程	抵达
超龄	适龄
适龄	超龄
炮火连天	河清海晏
河清海晏	炮火连天
文治	武功
武功	文治
井底之蛙	见多识广
见多识广	一孔之见,管中窥豹,井底之蛙,凭高望远,孤陋寡闻
专横跋扈	谦谦君子
捣乱	帮忙,安分
安分	捣乱,守分,放荡
言不及义	言必有中
忸怩	大方
提心吊胆	悠然自得,逍遥自在
勇而无谋	有勇有谋
费尽心机	无所用心
借债	还债
还债	借债
踌躇满志	灰心丧气
灰心丧气	自鸣得意,踌躇满志,兴高采烈,意气扬扬,沾沾自喜
拼	拆
拆	拼,装
层出不穷	寥若晨星
籴	粜
粜	籴
多才多艺	不学无术
开宗明义	旁敲侧击
苦难	幸福
安定	动荡,漂泊,动乱,惊悸,骚动,骚乱,飘泊
骚动	安定
朝阳	夕阳,残阳
夕阳	朝阳,夕晖,晨光
冬	夏
夏	冬
粗疏	邃密,细致,精密,细密,周密,精细
精细	粗忽,粗疏,粗糙
处心积虑	心血来潮
心血来潮	处心积虑
水	火,陆,山
山	水
啼	笑
言而有信	言而无信,食言而肥
痴呆	伶俐,智慧
追本求源	舍本逐末
舍本逐末	追本求源
相提并论	一分为二
一分为二	相提并论
喷薄欲出	日薄西山
日薄西山	喷薄欲出,如日中天,旭日东升
孱弱	粗壮,强壮,壮实
植党营私	招贤纳士
招贤纳士	植党营私
花言巧语	肺腑之言,忠言逆耳
气宇轩昂	垂头丧气,萎靡不振
偶	奇,独
独	偶
参加	退出
退出	参加,进入
大有靠山	无依无靠
赞同	异议,批驳,反对,反驳
歹	好
屡见不鲜	百年不遇,盖世无双,少见多怪,登峰造极,千载难逢
掩鼻而过	蜂拥而至
蜂拥而至	掩鼻而过
哀鸿遍野	民康物阜,普天同庆
戕害	救援,爱护
断简残编	连篇累牍,长篇大论
放马后炮	先入之见
先入之见	放马后炮
孤军作战	招兵买马
天各一方	形影不离,近在咫尺,难分难解
天花乱坠	平铺直叙
出头露面	深居简出,销声匿迹,隐姓埋名,埋头苦干
深居简出	仆仆风尘,出头露面,抛头露面
夜郎自大	妄自菲薄,虚怀若谷
正牌儿	杂牌儿
杂牌儿	正牌儿
楚囚对泣	败而不馁,谈笑自若
败而不馁	楚囚对泣
复会	休会
休会	复会,闭会
家破人亡	安居乐业,太平盛世
家贫如洗	家财万贯,富丽堂皇
分崩离析	不可开交
不可开交	分崩离析
投井下石	雪中送炭
动人心弦	平淡无奇
恒河沙数	沧海一粟
沧海一粟	恒河沙数
独辟蹊径	拾人牙慧,鹦鹉学舌,墨守陈规
拾人牙慧	独辟蹊径
谈笑自若	惶恐不安,张皇失措,谈虎色变,楚囚对泣,目瞪口呆
要价	还价
还价	讨价,要价
简	繁
繁	简
博闻强记	不学无术
声	韵
韵	声
不自量力	蚍蜉撼树,力所不及,度德量力,量力而行
欢聚一堂	妻离子散
妻离子散	欢聚一堂
卖劲	偷懒
偷懒	卖劲
健康长寿	香消玉殒
香消玉殒	健康长寿
捷报频传	杳如黄鹤,节节败退
杳如黄鹤	捷报频传
鹏程万里	日暮途穷,走投无路
新硎初试	饱经风霜
仰承鼻息	不以为然
稳固	动摇
真心实意	虚与委蛇,虚情假意
高价	低价,廉价
低价	高价
悲哀	欢乐
远大	短浅
短浅	远大
老手	生手
汗流浃背	滴水成冰
滴水成冰	汗流浃背,流金铄石
顺差	逆差
逆差	顺差
发现	埋没,湮没
埋没	发现,发掘
何乐不为	死不瞑目
奸猾	忠厚
不欢而散	济济一堂
兴味索然	兴致勃勃,妙不可言
妙不可言	兴味索然
朝不虑夕	高枕无忧
金榜题名	名落孙山
名落孙山	金榜题名,平分秋色,名列前茅,鳌头独占,首屈一指
刺眼	顺眼,悦目
顺眼	刺眼,碍眼
合而为一	分而为二
分而为二	合而为一
无所畏惧	面不改容,不寒而栗,毛骨悚然,畏首畏尾,投鼠忌器
敞开	关闭
有名无实	名实相副,名不虚传,名副其实
错综复杂	井然有序
任命	解任,撤职
撤职	任命
必要劳动	剩余劳动
剩余劳动	必要劳动
颠倒是非	实事求是
成仁取义	降志辱身,苟且偷生,祸国殃民
地角天涯	近在咫尺
残花败柳	姹紫嫣红,百花齐放
所向披靡	风声鹤唳,闻风而逃,弃甲丢盔,弃甲曳兵,节节败退,屁滚尿流
生吞活剥	融会贯通,一笔抹煞
一笔抹煞	生吞活剥
气壮山河	气息奄奄
气息奄奄	气吞山河,气壮山河,气贯长虹,生机勃勃
单眼	复眼
复眼	单眼
临危不惧	如临大敌,临阵脱逃,不寒而栗,惊惶失措
惊慌失措	从容不迫,泰然自若,镇静自若,镇定自若,不慌不忙
不可救药	起死回生,医药罔效,药到病除
起死回生	不可救药
星罗棋布	寥寥无几,寥若晨星
事半功倍	事倍功半,剜肉补疮,舍近求远
舍近求远	事半功倍
预赛	决赛
决赛	复赛,预赛
轻侮	恭敬
恭敬	轻侮,轻慢
信誓旦旦	言而无信
骨肉相连	背信弃义
破镜难圆	百年之好
感激涕零	恨之入骨,恩将仇报
恩将仇报	知恩必报,以德报恩,感恩图报,感激涕零
过目成诵	熟视无睹
熟视无睹	过目成诵
卑鄙	高尚
高尚	下流,卑劣,高上,庸俗,卑末,卑鄙
波动	稳定
稳定	波动,动荡,漂摇
昙花一现	不可磨灭,万古长青,旷世难逢,数见不鲜
不可磨灭	昙花一现
亡国之音	哀而不伤
哀而不伤	亡国之音
分化瓦解	精诚团结,戮力同心
傲然屹立	摇摇欲坠
草本	木本
木本	草本
真相	假相,假象
假象	真象,真相
心宽体胖	弱不禁风
权宜之计	长久之计
长久之计	权宜之计
辞退	聘请
聘请	辞退
名行其事	通力合作
通力合作	名行其事,不近情理
出世	去世,作古
去世	出世,健在,降生,在世
无比欢欣	苦不堪言
行时	过时
过时	流行,时兴,时髦,行时,应时
故乡	异乡,他乡,同乡,异域
异乡	故乡,家乡
风雨同舟	过河拆桥
显而易见	图穷匕见
图穷匕见	显而易见
虚拟	真实
真实	虚假,虚拟,失实,子虚,做作
无奇不有	平淡无奇
麻麻黑	麻麻亮,蒙蒙亮
麻麻亮	麻麻黑
拘捕	释放
惊恐万状	不动声色
鳞次栉比	杂乱无章,参差不齐
杂乱无章	鳞次栉比,齐齐整整,井然有序,井井有条
卓有成效	鲜有成效
鲜有成效	卓有成效
包庇	告发,检举,揭发
检举	袒护,包庇,窝藏
有目无睹	有目共睹
有目共睹	有目无睹
修理	损坏
损坏	维修,修理,保护
早点	夜,夜＃
夜＃	早点
必然王国	自由王国
自由王国	必然王国
毁于一旦	坚不可摧
想方设法	无计可施
平和	烈性,剧烈,险恶,严酷,凶恶,驯善
剧烈	平和,轻微
狂妄自大	频频入礼,谦虚谨慎
榫头	卯眼
卯眼	榫头
寸步不离	不即不离
不即不离	寸步不离
府上	尊府,舍下
舍下	贵府,府上
寻根究底	不求甚解
怒	喜
喜	怒,悲,厌,愁
寄人篱下	自立门户,依人篱下,自食其力
自食其力	城下之盟,寄人篱下,坐享其成,不劳而获
痛改前非	积重难返,铸成大错
铸成大错	痛改前非
万壑千岩	一马平川
一马平川	崇山峻岭,万壑千岩,千山万壑,千岩万壑
书面	口头
口头	书面
敝帚自珍	在所不惜,视如草芥,视如敝屣
视如草芥	敝帚自珍,奉为圭臬
不打自招	屈打成招
狐疑不决	当机立断
当机立断	犹豫不决,狐疑不决,举棋不定,刚毅果决,游移不决,举棋若定,优柔寡断,当断不断,畏首畏尾,瞻前顾后
寝食不安	心安理得,泰然处之
如坐春风	如临大敌
如临大敌	临危不惧,如坐春风
君子一言，快马一鞭	言而无信
息息相通	不相往来,漠不关心
叶公好龙	名实相符,名副其实
愉快	痛苦,悲忧,郁悒,忧郁,悲伤
高洁	卑污,鄙污
卑污	纯洁,高洁
介入	旁观
分工	合作
不知所以	老马识途
直不笼统	曲里拐弯
曲里拐弯	直不笼统
爱称	憎称
憎称	爱称
不知所云	出口成章
声援	申讨
申讨	声援
荏	厉
厉	荏
风靡一时	久盛不衰
久盛不衰	风靡一时
夸大	缩小
嘘寒问暖	漠不关心
实学	虚名
虚名	实学,实权
众叛亲离	众望所归,人心所向,笼络人心
神思恍惚	泰然处之
芬芳	腐臭
腐臭	芬芳
缺点	成绩,优点
优点	瑕玷,毛病,劣点,缺陷,缺点
望文生义	字斟句酌
嬉笑	怒骂
怒骂	嬉笑
扣人心弦	无动于衷
沾沾自喜	垂头丧气,愁肠百结,灰心丧气
起航	停航,返航
返航	出航,起航
甜丝丝	苦唧唧,苦咧咧
确凿无疑	无中生有
无中生有	有案可稽,确凿无疑
模本	摹本
摹本	模本
空缺	满额
满额	空额,空缺
吠影吠声	针锋相对
佛头着粪	锦上添花
公诸同好	秘而不宣
宝物	废物
废物	宝物,良材,蔽屣
不一而足	屈指可数
朝不保夕	安然无恙
明亮	曚昽,阴暗,幽暗,昏暗,暗淡
身教	言教
言教	身教
暧昧不明	爱憎分明,鬼鬼祟祟
爱憎分明	暧昧不明
质	量
量	质
嫡系	旁系,旁支
旁系	嫡系,直系
戮力同心	分化瓦解
暗无天日	枯木逢春,重见天日,光天化日
减弱	加强,增强,壮大
增强	削弱,冲淡,减弱
乞降	受降
受降	投降,乞降
虚情假意	假仁假意,深情厚意,实心实意,真心实意
深情厚意	虚情假意
壁垒森严	不堪一击
不可或缺	多此一举
多此一举	不可或缺,必不可少
继日成功	付诸东流
付诸东流	继日成功
消声匿迹	大张旗鼓,粉墨登场
不堪入目	赏心悦目
无风起浪	息事宁人
息事宁人	煽风点火,播弄是非,无风起浪
偃武修文	穷兵黩武,兵荒马乱
兵荒马乱	太平盛世,偃武修文,颠沛流离
匀速运动	变速运动
变速运动	匀速运动
得心应手	所谋辄左,力不胜任,不文不武,进退两难,随心所欲
不文不武	得心应手
神气活现	不耻下问
不耻下问	自高自大,好为人师,神气活现
浮躁	稳重,沉着,塌实,嚣浮
丧尽天良	大慈大悲
大慈大悲	穷凶极恶,罪不容诛,丧尽天良,灭绝人性
罢官	复职
赤日炎炎	天寒地冻
师	生,生3,徒
窗明几净	满屋尘灰
满屋尘灰	窗明几净
深不可测	浅而易见,真相大白
缠绵	解脱
解脱	束缚,缠绵
报国	叛国
叛国	报国,殉国
灯火阑珊	万家灯火
万家灯火	灯火阑珊
同病相怜	幸灾乐祸
幸灾乐祸	同病相怜,兔死狐悲,物伤其类,哀矜勿喜
城下之盟	自强自力,自食其力
轻车简从	前呼后拥
和蔼可亲	穷凶极恶,正颜厉色,气势汹汹
穷凶极恶	大慈大悲,和蔼可亲
相对无言	说三道四
说三道四	默不做声,相对无言
助纣为虐	疾恶如仇,除暴安良
小题大作	大题小作,等闲视之
无所不包	一贫如洗
一贫如洗	家财万贯,无所不包
杂	纯
纯	杂
寿终正寝	一息尚存,寿比南山
一息尚存	寿终正寝
严密	严整,松散
适当	失当
失当	不妥,适当,得当,正当,不当
不恤人言	谨言慎行
谨言慎行	为非作歹,不恤人言,祸从口出
空气污染	沁人心脾
沁人心脾	空气污染
不吝指教	骄傲自满
夜阑人静	鸡犬不宁,人声鼎沸
塌陷	隆起
隆起	凸起,塌陷
热泪盈眶	眉开眼笑
眉开眼笑	叫苦不迭,怒目而视,泪如雨下,热泪盈眶,涕泗滂沱,眉眼不开,愁眉锁眼,捶胸顿足,叫苦连天,椎心泣血
罪过	功劳,功绩
功劳	罪过
抱头鼠窜	得胜班师
得胜班师	抱头鼠窜
晚上	早晨,早上
早晨	晚上,晚间
按捺	放纵
白昼	黑夜
黑夜	白昼,夜间,星夜
当面	背后,背地
背后	正面,当面
自尊自爱	自掘坟墓
自掘坟墓	自尊自爱
认帐	赖帐,抵赖
赖帐	认帐
信口开河	守口如瓶,三缄其口,信而有征
有声有色	平淡无奇,无声无息
藕断丝连	丁一卯二,丁是丁，卯是卯,一刀两断
丁一卯二	藕断丝连
聊以自慰	若有所失
本位	全局
全局	本位
自我陶醉	若有所失
急中生智	无计可施
抗税	上税
上税	偷税,免税,抗税
春暖花开	天寒地冻
罗唆	简练,繁冗
简练	罗唆,罗嗦
小令	长调
长调	小令
铁石心肠	女儿意态,心慈面软
心慈面软	铁石心肠,心狠手辣
相形见绌	出人头地
出人头地	相形见绌
地久天长	喜新厌旧
曙光	暮色
暮色	曙光,晓色
透彻	浮浅
浮浅	透彻,肤浅
人云亦云	固执己见
艰辛	安适
安适	艰辛,艰难
一日千里	慢条斯理
聪明伶俐	呆头呆脑,蠢如鹿豕
蠢如鹿豕	聪明伶俐
吃亏	划算,沾光
划算	吃亏
淋漓尽致	轻描淡写,理屈词穷
厌弃	喜爱
喜爱	厌恶,愤恨,嫌恶,讨厌,憎恶,厌弃
良	莠,劣
莠	良
虚心好学	师心自用
师心自用	虚心好学
巨富	赤贫
赤贫	巨富
开张	倒闭,停业
停业	开张,开业
沙文主义	国际主义
国际主义	沙文主义
推波助澜	随波逐流
产	销
销	购,产
富庶	不毛,贫穷
如愿以偿	事与愿违,难偿所愿,适得其反
适得其反	如愿以偿
错落不齐	错落有致
错落有致	乱无章,错落不齐
匮乏	丰富,丰盛
瑜不掩霞	瑕不掩瑜
瑕不掩瑜	瑜不掩霞,瑜不掩瑕
尸位素餐	枵腹从公,分秒必争
天壤悬隔	相差无几
康庄大道	坎坷不平,歪风邪气,羊肠小道
坎坷不平	康庄大道
确信不疑	胡思乱想
胡思乱想	确信不疑
弃	拾
拾	丢,扔,弃
违	奉
奉	违
罪有应得	罚不当罪
内政	外交
手忙脚乱	从容不迫,行若无事
递增	递减
递减	递增,递加
感人肺腑	无动於衷,无动于衷
内忧外患	国泰民安
叫苦不迭	眉开眼笑
偏重	并重
并重	偏重
如堕烟海	豁然开朗
澄清	搅混,搅浑,混淆,浑浊
指日可待	杳无音信,遥遥无期
遥遥无期	当务之急,为期不远,指日可待
花样翻新	老调重弹
老调重弹	花样翻新
箭不虚发	无的放矢,百无一存
记	忘
忘	记
中间	两头
两头	中间
初露锋芒	大器晚成
无伤大雅	损伤根本
损伤根本	无伤大雅
延缓	提前,加速
一面之词	兼听则明
兼听则明	一面之词
反感	好感
好感	反感
通亮	黢黑
黢黑	通亮,雪白
祸不单行	双喜临门
双喜临门	祸不单行
万劫不复	卷土重来
卷土重来	万劫不复,偃旗息鼓,销声匿迹
陈陈相因	标奇立异,标新立异,革故鼎新
黑灯瞎火	灯火辉煌
灯火辉煌	昏天黑地,黑灯瞎火
青黄不接	后继有人
出乖露丑	绰约多姿
绰约多姿	出乖露丑
气急败坏	平心静气,心平气和
豁然贯通	大惑不解
大惑不解	豁然贯通
精	粗,傻
深思熟虑	不假思索
夜以继日	蹉跎岁月
震天动地	无声无息
酒足饭饱	食不果腹,饥肠辘辘
食不果腹	酒足饭饱
扶摇直上	急转直下,一落千丈
一言堂	群言堂
群言堂	一言堂
牵肠挂肚	置于脑后
置于脑后	牵肠挂肚
老人	小孩
小孩	老人
粗重	尖细
尖细	粗重
风驰电掣	蜗行牛步,老牛破车,蜗步龟移
蜗行牛步	风驰电掣
严惩	宽饶,宽贷
宽贷	严惩
自由民	奴隶
精挑细选	寻章摘句
寻章摘句	精挑细选
旋乾转坤	回天乏术
回天乏术	旋乾转坤,回天之力
主犯	从犯
从犯	主犯
力求	力避
瘟神	傩神
傩神	瘟神
盗名欺世	忠诚老实,实事求是
勤俭	奢侈
仆人	主人
斩钉截铁	优柔寡断,犹豫不决,拖泥带水
切肤之痛	无关痛痒
母本	父本
父本	母本
易懂	费解
费解	易懂
台上	台下
台下	台上
持之以恒	浅尝辄止,一暴十寒,有始无终
风云人物	无名小卒
暴利	薄利
薄利	重利,暴利
艳	素
憎恨	热爱,怜爱
热爱	憎恨,痛恨
枯木逢春	暗无天日
死而无憾	抱恨终天
公物	私物,私产
私产	公物,公产
就职	辞职
辞职	就职
人迹罕至	人山人海
失约	践约,依约,履约
践约	负约,失约
违天悖理	仗义执言
仗义执言	违天悖理
势合形离	貌合神离
屋上架屋	精兵简政
精兵简政	屋上架屋,迭床架屋,叠床架屋
人面兽心	正人君子
漏洞百出	天衣无缝,滴水不漏,十拿九稳
内	外,边
奴颜媚骨	威武不屈
威武不屈	奴颜媚骨,奴颜婢膝
爱抚	鞭挞,虐待
虐待	侍奉,优待,爱抚,伺候
封闭	开放,打开
忠言	谗言
谗言	忠言
自卑感	优越感
优越感	自卑感
绝无仅有	三番五次,泛滥成灾
三番五次	绝无仅有
避重就轻	避实击虚
避实击虚	避重就轻
画地为牢	任其驰骋
任其驰骋	画地为牢
前门	后门
后门	前门
干枯	繁茂,湿润,水灵
牢不可破	坚如磐石,不绝如缕,溃不成军,一触即溃
溃不成军	横扫千军,牢不可破
泄露	保守
百发百中	百不一存
百不一存	百发百中
涂脂抹粉	本来面目
心旷神怡	心如火焚,心慌意乱,神不守舍
心如火焚	心旷神怡
袖手旁观	义不容辞,挺身而出,见死不救
挺身而出	袖手旁观,缩头缩脑,望而生畏,畏缩不前
挥金如土	断齑画粥,爱财若命,爱财如命
断齑画粥	挥金如土,挥霍无度
倾巢而出	按兵不动
待理不理	满腔热情
附和	反驳
万象更新	依然如故,万古不变
依然如故	万象更新,脱胎换骨,一了百了,焕然一新,面目一新,面目全非
安家落户	南征北战
南征北战	安家落户
忠君爱国	乱臣贼子
乱臣贼子	忠君爱国
上行下效	源清流洁
源清流洁	上行下效
万古长青	昙花一现
不思悔改	闭门思过
闭门思过	不思悔改
深恶痛绝	老牛舐犊,爱不释手,小鸟依人
爱不释手	束之高阁,深恶痛绝
务实	务虚
务虚	务实
各得其所	人浮于事
人浮于事	各得其所
坏处	好处
侃侃而谈	支吾其词,缄口结舌,噤若寒蝉,沉默寡言,缄口无言
不择食	挑肥拣瘦
挑肥拣瘦	不择食,饥不择食,舍己为人
蛟龙得水	怀才不遇,蛟龙失水
贪赃枉法	廉洁奉公,正直无私,法不阿贵,明镜高悬,公正无私
明镜高悬	贪赃枉法
除旧布新	因循守旧,率由旧章,蹈常袭故
因循守旧	改弦更张,移风易俗,除旧布新,革故鼎新,破旧立新
血流成河	兵不血刃
刻骨仇恨	以德报怨
差强人意	大失所望
起早贪黑	无所事事
夸夸其谈	默默无言,默不作声,三缄其口
三缄其口	信口雌黄,夸夸其谈,信口开河
一唱三叹	驴鸣狗吠
驴鸣狗吠	一唱三叹
德才兼备	德薄能鲜,德薄才疏
德薄才疏	德才兼备
手无寸铁	荷枪实弹
正凶	帮凶
慌手慌脚	稳如泰山
清洁	污浊,污秽
污浊	纯净,清洁,清澄
污七八糟	井井有条
振振有辞	张口结舌,理屈词穷
蓬门荜户	朱门大户,书香门第,雕梁画栋
朱门大户	蓬门荜户
不拘一格	如出一辙
救死扶伤	杀人如麻,落井下石
行远自迩	一步登天
花花公子	白面书生
地大物博	弹丸之地
弹丸之地	地大物博,地广人稀
磨砺以须	临阵磨刀
临阵磨刀	磨砺以须
天下为公	天下为家
天下为家	天下为公
碌碌无为	前程万里,精明强干
兼收并蓄	以蠡测海
陡	平
天罗地网	逃之夭夭
尊贵	低＃,低贱
低＃	尊贵
先睹为快	后发制人
破坏	爱护,保护,维护,建设,巩固
以眼还眼，以牙还牙	退避三舍
捧腹大笑	饮泣吞声,泪如泉涌
投鼠忌器	肆无忌惮,无所畏惧
机关用尽	束手无策
降表	战书
战书	降表
治标	治本
治本	治标
后继乏人	后继有人
歪风邪气	康庄大道
配房	正房
正房	偏房,配房,厢房
灾祸	喜庆,幸运
喜庆	灾祸
谈笑风生	不苟言笑
按部就班	急于求成,勇往直前,闻风而动
宽厚	刻薄
喊冤叫屈	委曲求全
委曲求全	喊冤叫屈
洋洋得意	郁郁寡欢,愁肠百结,黯然销魂
置之度外	耿耿於心,耿耿于怀
专程	顺便,顺道
顺道	专程
俗不可耐	雅人深致
雅人深致	俗不可耐
天差地别	势均力敌,旗鼓相当
旗鼓相当	相形失色,天差地别,寡不敌众
喜闻乐见	惨不忍闻,痛恨不已
惨不忍闻	喜闻乐见
无所不知	一窍不通
排难解纷	挑拨离间,拨弄是非
拨弄是非	排难解纷
异乎寻常	平淡无奇
改过自新	怙恶不悛,顽固不化,执迷不悟
众口一词	众说纷纭
班师回朝	安营扎寨,调兵遣将
乐而忘返	乐极生悲
壮实	孱弱
弥天大罪	盖世功勋,丰功伟绩
稳扎稳打	轻举妄动
轻举妄动	步步为营,稳扎稳打,四平八稳
结集	分散
公理	谬论
谬论	真理,卑见,公理
排除万难	瞻前顾后
外敌	内奸
内奸	外敌
大地回春	冰天雪地
冰天雪地	冰雪消融,春色满园,大地回春
晚	早
早	晚
古音	今音
今音	古音
一穷二白	丰衣足食,人给家足
照本宣科	断章取义
断章取义	实事求是,照本宣科
显达	卑微
卑微	显贵,显赫,显达,显要
放下屠刀，立地成佛	死不改悔
死不改悔	翻然悔悟,积重难返,放下屠刀，立地成佛
鹦鹉学舌	独辟蹊径
秉公执法	徇私枉法
徇私枉法	秉公执法
奸贼死党	钦差大臣
钦差大臣	奸贼死党
源远流长	无本之木
无本之木	源远流长
足不出户	走南闯北
走南闯北	足不出户
洋洋大观	微不足道
微不足道	变本加厉,洋洋大观
祛邪	扶正
扶正	祛邪
勇冠三军	畏敌如虎
畏敌如虎	勇冠三军
古为今用	以古非今
以古非今	古为今用
内外交困	万事亨通,左右逢源
五黄六月	十冬腊月
十冬腊月	五黄六月
荒诞不经	不容置疑
事关全局	无关痛痒
脱脂	全脂
全脂	脱脂
著作等身	胸无点墨
明晰	模糊
融会贯通	生吞活剥,穿凿附会
穿凿附会	融会贯通
视同儿戏	慎重其事,小心翼翼
小心翼翼	视同儿戏,粗心大意,掉以轻心,粗枝大叶,毛手毛脚
爱怜	厌恶
后代	前辈
前辈	后代
冷飕飕	暖和和,热烘烘
热烘烘	冷飕飕,冷冰冰
血海深仇	大恩大德
乘风破浪	裹足不前
裹足不前	义无返顾,乘风破浪,勇往直前,高歌猛进
举世瞩目	默默无闻
轻于鸿毛	举足轻重,重于泰山
举足轻重	不屑一顾,无足轻重,轻于鸿毛,可有可无,不足挂齿,细枝末节,无关大局
坐失良机	分秒必争,趁热打铁,过後行兵
谢天谢地	怨声载道
鱼龙混杂	去伪存真
来日方长	时日无多,急不可待,时不我与,事不宜迟
急不可待	慢条斯理,来日方长
新伙伴	老搭当,老搭档
老搭当	新伙伴
生存	死亡,毁灭,灭亡
死亡	出生,生存
依依不舍	一刀两断
晕厥	苏醒
苏醒	昏迷,昏厥,沉睡,晕厥
积极	消极
默默无言	棘棘不休,声嘶力竭,夸夸其谈,喋喋不休
声嘶力竭	默默无言
回头是岸	怙恶不悛,咎由自取,执迷不悟
怙恶不悛	改过自新,改邪归正,洗心革面,死不悔改,回头是岸
五湖四海	方寸之地
方寸之地	五湖四海
出口伤人	谦厚有礼
倒	正,立
风吹浪打	风平浪静
曚昽	明亮
精疲力竭	精神抖擞,精力充沛,余勇可贾
荆棘载途	万事亨通,金光大道
泣不成声	笑容可掬
笑容可掬	声泪俱下,泣不成声,愁眉苦脸,咬牙切齿
支2	主
怅然若失	得意忘形
有隙可乘	无隙可乘
鹤立鸡群	滥竽充数
滥竽充数	出类拔萃,货真价实,鹤立鸡群,名副其实
道路以目	敢说敢做
敢说敢做	道路以目
热乎乎	冷冰冰
冷冰冰	暖和和,热烘烘,热乎乎
兴妖作怪	风平浪静
读书无用	开卷有益
开卷有益	读书无用
喜眉笑脸	愁眉苦脸
澄澈	混浊
混浊	澄澈,清澈,清白
屏弃	吸收
替身	正身
正身	替身
劳燕分飞	鸾翔凤集
鸾翔凤集	劳燕分飞
正中下怀	大失所望
深度	广度
广度	深度
学而不厌	好为人师
好为人师	不耻下问,学而不厌
饿	饱
吉星高照	生不逢时,凶多吉少
矜才使气	胆小如鼠,小心谨慎
收回	借出,付出,发出
省吃俭用	大手大脚
喜事	吉事,丧事
丧事	喜事
板	活
捕风捉影	确凿不移
鱼米之乡	不毛之地,穷山恶水
勃谿	和睦
和睦	勃谿,不和
赤胆忠心	口是心非
口是心非	言行一致,赤胆忠心,表里如一,馨香祷祝,心口如一,心口合一
殚精竭虑	敷衍塞责
独自	结伴
结伴	独自,单独
赚	赔,蚀
赔	赚
春兰秋菊	半斤八两
半斤八两	相去悬殊,春兰秋菊
神仙	凡人
凡人	异人,仙人,伟人,神仙
何去何从	听天由命
其乐无穷	悲不自胜
悲不自胜	喜不自胜,乐不可支,其乐无穷
意料之中	不期而然,从天而降
从天而降	意料之中
见缝插针	针插不入,水泼不进
针插不入	见缝插针
惜墨如金	拖泥带水
开水	冷水,生水
生水	开水
杳无音信	空谷传声,指日可待
解毒	中毒
中毒	解毒
缺陷	优点
举世无敌	一触即溃,不堪一击
如饥似渴	四平八稳
张皇失措	从容不迫,胸中无数,成竹在胸,谈笑自若
轻佻	沉稳,正经,庄重
恭顺	跋扈
跋扈	恭顺
钳口结舌	直言不讳
事后	预先,事前
事前	事後,事后
挂牵	放心
开启	关闭
无产阶级	资产阶级
资产阶级	无产阶级,工人阶级
力挽狂澜	力不能支
无恶不作	秋毫无犯
蜂拥而入	破门而出
破门而出	蜂拥而入,破门而入
切中事理	痴心妄想,痴人说梦
痴人说梦	切中事理
世外桃源	人间地狱
人间地狱	世外桃源
惶恐不安	谈笑自若
声色犬马	流芳百世
流芳百世	声色犬马,谬种流传,声名狼藉,遗臭万年,名垂青史,声色狗马
压抑	发挥,昂扬,扶持,轻松
发挥	压抑
路不拾遗	巧取豪夺
如日中天	桑榆暮景,日薄西山
桑榆暮景	如日中天,风华正茂
西学	中学
中学	西学
心力交瘁	心广体胖,神采奕奕
借贷	偿还
胶柱鼓瑟	通达权变
通达权变	守株待兔,胶柱鼓瑟
恰到好处	矫枉过正
矫枉过正	恰到好处
奴	主
非亲非故	沾亲带故
沾亲带故	非亲非故
快活	忧愁,忧伤,愁闷
不教而诛	谆谆教诲
谆谆教诲	不教而诛
话中有话	直言不讳
违犯	遵守
遵守	违反,违犯,违背,触犯
当众	背＃,背
背＃	当众
耳闻不如目见	道听途说
道听途说	耳闻不如目见
心劳日拙	蒸蒸日上,欣欣向荣
忍俊不禁	强颜欢笑
强颜欢笑	忍俊不禁
败仗	胜仗
胜仗	败北,败仗,败阵
荆天棘地	光天化日
光天化日	暗无天日,月黑风高,荆天棘地
显著	细微
细微	明显,显著
见风使舵	一成不变
不甘寂寞	不闻不问
提倡	阻止,制止,反对
制止	纵容,提倡,放任
浑身是胆	胆小如鼠
天伦之乐	看破红尘,孤苦伶仃
看破红尘	天伦之乐
波澜壮阔	风平浪静,一潭死水
一潭死水	波澜壮阔
谬误	真理,准确
抓紧	捏紧,放松
放松	勒紧,加紧,抓紧
夸富	哭穷
哭穷	摆阔,夸富
简括	详尽
详尽	简括,粗略,节略,简略,不详
求贤若渴	嫉贤妒能
嫉贤妒能	求贤若渴
有形	无形
无形	有形
洪大	细小
闻风而动	按部就班
衣锦夜行	衣锦还乡
衣锦还乡	离乡背井,衣锦夜行
高人一等	低三下四,低人一等,不亢不卑
得不偿失	乞浆得酒,一举两得
一举两得	鸡飞蛋打,得不偿失
樗栎庸材	才华出众
才华出众	樗栎庸材
姗姗来迟	捷足先登,争先恐后
捷足先登	姗姗来迟
自吹自擂	实事求是
卵生	胎生
胎生	卵生
投身其中	超然物外
誓不两立	亲密无间
走马看花	下马看花
装腔作势	落落大方
落落大方	煞有介事,答答含羞,装腔作势
知法犯法	遵纪守法
遵纪守法	违法乱纪,知法犯法
逢	别
别	逢
副	正
惹草拈花	忠心耿耿
英雄好汉	无名小卒
绝口不道	津津乐道
津津乐道	绝口不道,沉默寡言
杯盘狼藉	井然有序
引力	斥力
斥力	吸力,引力
后知后觉	先知先觉
先知先觉	不知不觉,后知后觉
唯心论	唯物论
唯物论	唯心论
九牛二虎之力	举手投足
举手投足	九牛二虎之力
便当	麻烦
沉郁	舒畅
雪白	乌黑,漆黑,黢黑
命中注定	祸福无门
祸福无门	命中注定
服役	退伍
退伍	从军,服役
手到病除	病入膏肓
病入膏肓	手到病除,妙手回春
海底捞月	行之有效,立杆见影
名实相副	名不副实,有名无实
收拢	放开,铺开,卷起
丑声远播	名垂千古
名垂千古	丑声远播
一蹴而就	欲速不达,欲速则不达
欲速则不达	一蹴而就
抢购	抛售
抛售	囤积,抢购
语重心长	冷言冷语,轻描淡写
坚忍不拔	全心全意,摇摆不定
目不识丁	满腹经纶,精通文翰,学富五车
学富五车	目不识丁,不辨菽麦,蒙昧无知,博学多才
殊	同
尾	头,首
头	脚,尾
独创	摹仿,摹拟,抄袭,模拟
抄袭	创新,独创
嘉许	贬斥
贬斥	晋升,嘉许,诋譭,弹劾
煞费苦心	掉以轻心
掉以轻心	煞费苦心,小心翼翼,郑重其事
阶下囚	座上宾,座上客
座上宾	阶下囚
全副武装	赤手空拳
播弄是非	息事宁人
制定	取消
取消	制定
吉祥如意	时乖命蹇
屏气凝神	心不在焉
朔月	望月
望月	朔月,满月
天灾人祸	喜从天降
喜从天降	天灾人祸,祸从天降
治	乱
釜底抽薪	沸汤沸止,火上浇油,扬汤止沸
沸汤沸止	釜底抽薪
含冤负屈	雷打不动
雷打不动	含冤负屈
如火如荼	无声无息
天南地北	望衡对宇
望衡对宇	天南地北,千里迢迢
千头万绪	洞若观火
马首是瞻	南辕北辙
不合时宜	因时制宜
因时制宜	刻舟求剑,不合时宜
恐慌	镇定
骨瘦如柴	心广体胖,大腹便便,滾瓜溜圆,脑满肠肥,身强力壮
心广体胖	骨瘦如柴,心力交瘁
绳之以法	逍遥法外
成群结队	形单影只,孑然一身,踽踽独行
孑然一身	形单影只,成群结队
挥洒自如	东扶西倒
东扶西倒	挥洒自如
推荐	自荐
自荐	推举,推荐
凶狠	慈祥,温和,善良
鄙污	高洁
断交	建交
建交	绝交,断交
万死不辞	畏首畏尾
草芥	珍宝,至宝
珍宝	草芥
整整齐齐	乱七八糟,犬牙交错
毛手毛脚	小心翼翼
神色不动	神魂颠倒
神魂颠倒	神色不动
黯然销魂	怡然自得,洋洋得意
战胜	战败
战败	打败,战胜
冤家路窄	旧雨重逢,风云际会
从宽发落	执法如山
仓皇失措	从容不迫,处之泰然
英雄豪杰	无名小卒
争斗	和解
和解	纷争,争执,格斗,僵持,争斗
知难而进	急流勇退,知难而退
伶牙俐齿	顿口拙腮
顿口拙腮	伶牙俐齿
抵足而眠	貌合神离
旺盛	严明,衰退
衰退	发展,隆盛,旺盛,振兴
坚贞不屈	卑躬屈膝,奴颜婢膝
奴颜婢膝	不屈不挠,坚贞不屈,趾高气扬,威武不屈
甚嚣尘上	风平浪静
蛮横	和蔼,讲理
摧残	造就,保护,哺育,培养,培育
专心致志	心不在焉,三心二意
上装	卸装
沸腾	平静
贫苦	富有
富有	贫苦,贫窭,贫穷,贫困
臭名远扬	金字招牌,名扬四海,驰名中外
金字招牌	臭名远扬
饮鸩止渴	从长计议
吸力	斥力
低廉	昂贵
淤塞	疏浚,疏通,疏濬
有备无患	临渴掘井
临渴掘井	曲突徙薪,未雨绸缪,常备不懈,江心补漏,有备无患
释	捕
捕	释
下达	上报
上报	下达,下发
兴风作浪	相安无事
相安无事	兴风作浪
应付自如	身不由己,束手待毙,捉襟见肘,应接不暇
通畅	阻滞,堵塞,障碍
爱惜	蹧蹋,糟蹋,糟践
糟践	爱惜
数不胜数	寥寥无几
反面无情	情深潭水,深情厚谊
深情厚谊	无情无义,反面无情
弃明投暗	弃暗投明
弃暗投明	弃明投暗
上水	下水
下水	上水
肮脏	洁净,纯洁,弄脏,干净
洁净	洗净,肮脏
空	实,满
满	缺,谦,空
莫逆之交	素昧平生
频频入礼	狂妄自大
背井离乡	安土重迁
安土重迁	离乡背井,四海为家,背井离乡
变数	常数
常数	变数
泛滥成灾	绝无仅有
结实	瘦弱,单弱
单弱	结实
过而能改	将错就错
拆台	撑腰,捧场
捧场	拆台
人稠物穰	人杰地灵
受奖	授奖,受罚
受罚	受赏,受奖,授赏
雷厉风行	按兵不动,拖拖拉拉,拖泥带水
行将就木	蒸蒸日上,万寿无疆
鸡飞蛋打	一举两得
精妙绝伦	粗制滥造
展望	回顾
意译	音译,直译
直译	意译
人无完人	求全责备
求全责备	人无完人,求同存异
悉听尊便	强人所难
庸医杀人	妙手回春
妙手回春	病入膏肓,庸医杀人
拥护	叛逆,反对
广阔天地	立锥之地
立锥之地	广阔天地,广土众民
离经背道	拨乱反正
功亏一篑	善始善终,大功告成
语无伦次	出口成章,井井有条,有条有理,头头是道,顺理成章
千里迢迢	朝发夕至,望衡对宇
增高	减低
减低	增高
谈何容易	一挥而就,垂手可得,挟山超海
垂手可得	谈何容易
间日	每日
每日	间日
退还	索取
死不甘心	心甘情愿
化名	真名
真名	本名,化名
文弱书生	赳赳武夫
赳赳武夫	文质彬彬,文弱书生
虚张声势	不动声色
动用	储存
储存	废弃,动用,支取
疾首蹙额	笑逐颜开
罪不容诛	功昭日月,立地成佛,大慈大悲
恶贯满盈	功德无量
祸从口出	谨言慎行
坐而论道	身经百战
难	易
易	难
组装	拆散
拆散	撮合,组装,拼凑
出神入化	平淡无奇
谆谆	藐藐
藐藐	谆谆
不痛不痒	死去活来,一语中的
一语中的	不痛不痒
归田	出仕
福星	祸水,灾星
灾星	福星
余	亏,缺
淡然处之	勇往直前
老态龙钟	鹤发童颜,年富力强
鹤发童颜	老态龙钟
肘腋之患	疥癣之疾
疥癣之疾	肘腋之患
无所作为	大有作为,大有可为,任重道远,知难而退
奖赏	处罚
处罚	奖赏
年富力强	老态龙钟,弱不胜衣
弱不胜衣	钢筋铁骨,年富力强
劳方	资方
资方	劳方
僧徒	俗人
俗人	僧徒
八面玲珑	面面俱圆,刚直不阿,心口如一,四处碰壁
众所周知	一无所知
一无所知	众所周知,如数家珍
脏	净
净	污,毛,脏
强迫	自愿
自愿	强制,强迫
若即若离	亲密无间,形影不离,水乳交融
逸	劳
劳	逸
在朝	在野
礼尚往来	来而不往
来而不往	礼尚往来
寸土必争	拱手相让
拱手相让	寸土必争
烟波浩渺	风平浪静
滚瓜烂熟	吞吞吐吐
重归于好	旧愁新恨
旧愁新恨	重归于好
名正言顺	理屈词穷,师出无名
说谎	诚实
公费	自费,私费
私费	公费
略见一斑	一览无遗
一览无遗	略见一斑
时过境迁	记忆犹新,一如既往
绝交	通好,建交
以卵投石	行之有效
烟消云散	烟雾弥漫
烟雾弥漫	烟消云散
宽绰	狭窄,拮据,窄巴,局促
浓重	稀薄
神出鬼没	按兵不动
答非所问	对答如流
公正无私	贪赃枉法
面黄肌瘦	容光焕发,红光满面,大腹便便
大腹便便	骨瘦如柴,面黄肌瘦
降志辱身	平反昭雪,成仁取义
健旺	衰老
衰老	强壮,健旺
先入为主	实事求是
振聋发聩	装聋作哑
装聋作哑	振聋发聩
高慢	谦逊
光润	粗糙
屈服	抵御,反抗
恪守不渝	背信弃义
责无旁贷	置身事外
满腹经纶	目不识丁,胸无点墨,博学多才
冲锋陷阵	望风而逃,临阵脱逃
说东道西	守口如瓶
无意识	有意识
有意识	下意识,无意识
三十六计，走为上计	坐以待毙
坐以待毙	笨鸟先飞,三十六计，走为上计,三十六策，走为上策,死里求生
志士仁人	魑魅魍魉,跳梁小丑
笨头笨脑	心明眼亮
心明眼亮	笨头笨脑,昏头昏脑
满满当当	空空荡荡
空空荡荡	满满当当
早衰	早熟
早熟	早衰
桀骜不驯	唯命是从,俯首听命,俯首贴耳,俯首帖耳
俯首帖耳	唯唯诺诺,不卑不亢,桀骜不驯
垂死挣扎	束手待毙
蓊蓊郁郁	赤地千里
捉襟见肘	疲於奔命,应付自如,游刃有余,寅吃卯粮,绰绰有余
油腻	清淡
清淡	浓郁,浓烈,油腻
反唇相讥	无言以对
如虎添翼	雪上加霜
坦诚相待	假仁假义,假装好人
假仁假义	坦诚相待,沥胆披肝,披肝沥胆,诚心诚意
一塌糊涂	井然有序
前线	后方
后方	前线,前方
蒙受	洗雪
洗雪	蒙受
公益	私利
私利	公益
煞有介事	落落大方,若有所失
开卷	闭卷
闭卷	开卷
闭关自守	救亡图存,对外开放,门户开放
救亡图存	闭关自守
恢复	断绝
断绝	相通,接续,恢复
赃官	清官
铺张	节俭
节俭	奢侈,铺张,糜费,吝鄙
钟爱	憎恶
憎恶	钟爱,喜爱
寡言少语	千叮万嘱
千叮万嘱	寡言少语
亲如手足	不共戴天
不共戴天	亲如手足,亲同手足
甜美	苦恼
诽谤	歌颂,颂扬
半路出家	科班出身,炉火纯青,训练有素,驾轻就熟
训练有素	半路出家
做贼心虚	若无其事
扶摇直下	急转直下
铺天盖地	蜻蜓点水
红灯	绿灯
绿灯	红灯
先天不足	得天独厚
得天独厚	先天不足
凶相毕露	一团和气
判若两人	一如既往,依然故我
提纲挈领	毛举细故,轻重倒置,不得要领
轻重倒置	提纲挈领
有头有尾	虎头蛇尾
莫明其妙	洞若观火
小恩小惠	大恩大德
铜墙铁壁	无坚不摧
无坚不摧	铜墙铁壁,不堪一击
人给家足	一穷二白
拍案而起	悠然自得
悠然自得	心惊胆战,提心吊胆,拍案而起
高僧	沙弥
沙弥	方丈,住持,高僧
盈余	亏损
亏损	嬴余,盈余,余盈
急匆匆	慢腾腾,慢悠悠
慢腾腾	急匆匆,急巴巴,慢吞吞,慢悠悠
谦称	敬称,尊称
尊称	谦称
志大才疏	才高意广
才高意广	志大才疏
壮健	瘦弱,衰颓
瘦弱	结实,强健,壮健,粗壮
适可而止	过犹不及,得寸进尺,贪得无厌
阿谀奉承	刚直不阿,刚正不阿
为非作歹	安分守己,谨言慎行,嘉言懿行,奉公守法
肝肠寸断	心花怒放,乐不可支
乐不可支	悲不自胜,肝肠寸断,痛不欲生
损公肥私	舍己为公,大公无私
舍己为公	损公肥私
离乡背井	安土重迁,衣锦还乡,衣锦荣归
凝练	冗长
万不得已	心甘情愿
夕	朝,旦
圆	方
方	圆
谜底	谜面
谜面	谜底
领	发,占
发	领,收
声势浩大	无声无息
应有尽有	空空如也,一无长物
完美无缺	一无可取,百孔千疮,金无足赤，人无完人
斩草除根	后患无穷,贻害无穷,养痈贻患,养虎遗患,姑息养奸
姑息养奸	斩草除根,严惩不贷
复古	革新
革新	更始,复旧,保守,守旧,复辟,复古,因循
消逝	出现
布衣之交	酒肉朋友
母音	子音
子音	母音
争光	丢丑
丢丑	争光,丢脸
以守为攻	以攻为守
以攻为守	以守为攻,以退为进
颗粒无收	五谷丰登
五谷丰登	颗粒无收,凶年饥岁
望	朔
朔	望
忧国忧民	祸国殃民
嘉言懿行	为非作歹
进退中绳	进退失据
进退失据	进退中绳,进退有常
周到	疏忽
疏忽	防范,提防,周到,精心
礼贤下士	傲世轻才,居高临下
居高临下	礼贤下士
昔不如今	今不如昔
悔之无及	顽固不化,甘之如饴,死不悔改
入赘	出嫁
出嫁	入赘
点播	条播
条播	点播
痛哭流涕	喜出望外
借	还
还	讨,赊,借,该,去,欠
容许	禁止
过失	成绩
成绩	缺点,问题,过失
揭穿	掩盖
上升	下降,下落,跌落
跌落	上升
重蹈覆辙	前车之鉴,改弦易辙,前车可鉴,吃一堑，长一智
前车之鉴	重蹈覆辙
肆无忌惮	规行矩步,投鼠忌器
负约	践约
爽利	拖沓
拖沓	俐落,拖拉,干脆,爽利
纹丝不动	闻风而起
闻风而起	纹丝不动
沧海桑田	一成不变
毒辣	仁慈,善良
无情无义	深情厚谊
淡季	旺季
旺季	淡季
添	减,落
千娇百媚	其貌不扬
顽皮	老实
日理万机	斗鸡走狗,无所事事
自命不凡	甘拜下风,自惭形秽,虚怀若谷
不尽人情	人之常情
人之常情	不尽人情
引吭高歌	浅酌低吟
浅酌低吟	引吭高歌
草草了事	兢兢业业
丧命	获救,健在
获救	丧命,遇难
穷困潦倒	财运亨通,平步青云
财运亨通	穷困潦倒,时乖运蹇
不屑一顾	举足轻重
陈词滥调	言简意赅
仇人相见	天作之合
天作之合	仇人相见
矢志不渝	见异思迁,朝三暮四
燃烧	熄灭
患得患失	大公无私
大公无私	患得患失,自私自利,冰清玉洁,公事公办,损公肥私,徇私舞弊
在劫难逃	鸿运高照
鸿运高照	在劫难逃
方便	麻烦
弹冠相庆	如丧考妣
如丧考妣	弹冠相庆,如获至宝
密切	疏远
成人之美	成人之恶,乱点鸳鸯,落井下石
醇厚	淡薄
淡薄	深切,深厚,醇厚
以退为进	突飞猛进,以攻为守
旧雨	新朋
一字千金	一文不值
置信	置疑
置疑	置信
显赫	卑微,微贱
经	纬,络
纬	经
正本清源	脚痛医脚
脚痛医脚	正本清源
临阵磨枪	防患未然,常备不懈
量才录用	一视同仁
勤快	懒惰
跑龙套	唱主角
唱主角	跑龙套
普渡众生	六亲不认
六亲不认	普渡众生
枕戈寝甲	高枕无忧
煞笔	起笔
起笔	收笔,煞笔
臭味相投	意气相投
意气相投	臭味相投,一丘之貉
一挥而就	谈何容易
喜怒无常	温文尔雅
恍惚	清醒
纯净	污浊
浓艳	淡雅,素淡
素淡	浓艳,艳丽
新月	残月
残月	新月
难分难解	天各一方
悲观	乐观
乐观	悲观,厌世
左思右想	不假思索
四通八达	穷途末路
世风日下	蒸蒸日上,移风移俗
懦夫	小丑,好汉,恶汉,勇士,英雄,铁汉
勇士	懦夫
亲同手足	不共戴天
如泣如诉	慷慨悲歌
慷慨悲歌	如泣如诉
随声附和	独具匠心,独立思考
独具匠心	千篇一律,随声附和
敌对	友好
友好	敌对
可憎	可爱
三头六臂	一无所长
一无所长	独具只眼,一技之长,三头六臂
细枝末节	举足轻重,荦荦大端
海底捞针	探囊取物,叹为观止,行之有效,缘木求鱼
弃甲曳兵	耀武扬威,所向披靡
急急忙忙	慢慢腾腾,慢慢悠悠
慢慢腾腾	急急忙忙
青天白日	半夜三更
半夜三更	大天白日,红日三竿,青天白日
长	幼,短
短	长
心如刀割	欣喜若狂,心花怒放
欣喜若狂	痛不欲生,怒气冲天,心如刀割,创巨痛深,五内如焚
温	凉
六神无主	镇静自若
镇静自若	丧魂落魄,惊慌失措,六神无主
深厚	淡薄,浅薄
元旦	除夕
除夕	元旦,正旦
臭烘烘	香喷喷
香喷喷	臭烘烘,香馥馥
精装	平装,简装
平装	精装
九牛一毛	成千累万,举不胜举
举不胜举	九牛一毛,屈指可数
一泻千里	迂回曲折
迂回曲折	一泻千里,拐弯抹角
大意	小心,马虎,经心,留心
小心	大意
反面人物	正面人物
正面人物	反面人物
欢聚	赋别,失散
及时	耽误,失时
耽误	及时
受害	受益
受益	受害
善罢干休	寻事生非
寻事生非	善罢干休
春寒料峭	春意盎然,春风和煦
上峰	下属
下属	上司,上峰
明枪暗箭	开诚布公
素净	鲜艳
终结	开始
除恶务尽	养虎遗患,杜绝後患
养虎遗患	斩草除根,斩尽杀绝,除恶务尽
意志消沉	精神抖擞
寡不敌众	强弱悬殊,势均力敌,云泥有别,旗鼓相当
水落石出	匿影藏形
气吞山河	气息奄奄
供过于求	供不应求
供不应求	供过於求,供过于求
忧心如焚	喜上眉梢,无忧无虑,心花怒放
心花怒放	心绪恶劣,闷闷不乐,肝肠寸断,声泪俱下,心如刀割,五内俱焚,忧心如焚
横扫千军	溃不成军
采购	经销,销售
销售	收购,采购,购买
戒备森严	一触即溃
金光大道	荆棘载途
停航	通航,起航
破绽百出	天衣无缝,无懈可击
叟	童
童	叟
鹿死谁手	和平共处
上口	拗口
拗口	上口,顺口
急功近利	高瞻远瞩
飞沙走石	春光明媚
春光明媚	飞沙走石
债主	债户
债户	债主
思绪万千	茫无头绪
茫无头绪	胸有成竹,思绪万千
驰名中外	臭名远扬,臭名昭著
臭名昭著	大名鼎鼎,驰名中外
前台	幕后,后台
后台	前台
另眼相看	置之不理
不可胜数	屈指可数
知恩必报	恩将仇报
失而复得	不翼而飞
不翼而飞	失而复得,合浦珠还
坤	乾
乾	坤
浑然一体	支离破碎
流离颠沛	安居乐业
隐蔽	揭开,暴露,公开,显露
体力劳动	脑力劳动
脑力劳动	体力劳动
弄巧成拙	弄假成真
弄假成真	弄巧成拙,画蛇添足
死皮赖脸	悬崖勒马
无微不至	漠不关心
有意	无意
监禁	释放
顺天应人	强奸民意
强奸民意	顺天应人
唯心主义	唯物主义
唯物主义	唯心主义
变态	常态,反常
常态	狂态,变态
忠诚老实	盗名欺世
肉中刺	掌上珠
掌上珠	肉中刺,灶下婢
扣题	走板,离题
离题	扣题
背离	遵循,归附
解衣推食	以毒攻毒
以毒攻毒	解衣推食
仰不愧天	伤天害理
苍天	大地
大地	天空,苍天
名实相符	叶公好龙
文不对题	探骊得珠
探骊得珠	文不对题
游牧	定居
定居	假寓,搬家,流浪,游牧
清爽	恶浊
恶浊	清爽
后福无量	后患无穷
后患无穷	后福无量,斩草除根
披麻戴孝	张灯结彩
张灯结彩	披麻戴孝
公然	暗里,暗地
暗地	公开,公然
乡村	城市
物伤其类	幸灾乐祸
违反	遵从,遵循,遵照,遵守
光阴似箭	日月如梭,度日如年
区别	混同
混同	区别,区分
一夫之用	以一当十
以一当十	卵与石斗,一夫之用
大获全胜	片甲不回,一败涂地,大败亏输
大败亏输	大获全胜
四面楚歌	歌舞升平,安然无恙,旗开得胜
为期不远	遥遥无期
点头之交	管鲍之交
管鲍之交	点头之交
智尽能索	游刃有余
激浊扬清	讳疾忌医
讳疾忌医	激浊扬清
山青水秀	穷山恶水
悲痛欲绝	抚掌大笑
抚掌大笑	悲痛欲绝
退场	上场,出场
下任	上任
上任	下任
明面上	暗地里
暗地里	明面上
捎带	专门
专门	附带,捎带,顺便
上司	属下,部属,下属,僚属
部属	上司,长官
可喜	可恶
诨名	本名
本名	外号,表字,真名,诨名,假名
众星捧月	各奔前程
宁缺毋滥	备位充数
备位充数	宁缺毋滥
身心交病	身强力壮
身强力壮	骨瘦如柴,弱不禁风,身心交病
妙趣横生	枯燥无味,味同嚼蜡
维修	损坏
倒行逆施	三从四德,顺理成章,不破不立,正道直行
不破不立	倒行逆施
至交	死敌
车水马龙	门庭冷落
门庭冷落	纷至沓来,车水马龙,熙熙攘攘,门可罗雀,门庭若市
趾高气扬	笑傲公卿,奴颜婢膝,不亢不卑,谦虚谨慎
山高水低	安然无恙
天上	地下
地下	天上
一意孤行	从善如流,孤行己见,集思广益,迷途知返
哀伤	欢乐
不落窠臼	按图索骥
按图索骥	不落窠臼,无迹可寻
一气呵成	断断续续,零敲碎打
零敲碎打	一气呵成
供	求
求	应,供
好人	吉人,坏人,歹人,奸人
坏人	好人
九死一生	安如泰山
等而下之	至高无上
至高无上	等而下之
衣锦荣归	离乡背井
全体	一面,部分
部分	全体,全部,一切,整体,整个
安之若素	如坐针毡
一斑	全豹
全豹	一斑
空头	多头
多头	空头
庞大	细小,精干
精干	庞大
烦躁	安宁,宁静,安静,安祥
七嘴八舌	沉默寡言
存放	领取
春色满园	冰天雪地,天寒地冻
散兵游勇	坚甲利兵
坚甲利兵	散兵游勇,赤手空拳
不可终日	安如泰山
短促	充裕
充裕	拮据,短促,紧迫
埋头苦干	出头露面,游手好闲
徒弟	师傅,师父
师傅	徒弟
辽阔	狭窄
浑水摸鱼	夜不闭户
夜不闭户	浑水摸鱼
虚度年华	死而后已
死而后已	虚度年华
坐享其成	自力更生,火中取栗,自食其力
同舟共济	各行其事,反目成仇
唇亡齿寒	隔岸观火
毫无二致	迥然不同,天壤之别
齐头并进	轻重缓急
轻重缓急	齐头并进
守株待兔	通达权变
至关紧要	无关宏旨
无关宏旨	至关紧要
升级	留级,跳级,降级
大失人望	大喜过望
大喜过望	大失人望,不堪回首,大失所望
糜费	节俭
巨	小
作法自毙	嫁祸于人,引咎自责,嫁祸他人,嫁祸於人
安邦定国	祸国殃民
舍生取义	苟且偷生
妣	考
考	妣
引言	后记
卑下	低下,崇高
崇高	卑下,低贱
抄近儿	绕远儿
绕远儿	抄近儿
主词	宾词
宾词	主词
洪亮	沙哑
沙哑	洪亮,嘹亮,清脆
自在阶级	自为阶级
自为阶级	自在阶级
外号	本名
利落	罗嗦
罗嗦	乾脆,利落,简练,爽快
媾和	交战,宣战,售、
售、	媾和
暖和	阴冷,寒冷,凉快
独立	并立,依靠,倚赖,附属,依赖
附属	独立
囚禁	释放
转弯抹角	开门见山,直捷了当
流露	掩饰
掩饰	流露,表白
散文	韵文
韵文	骈文,散文
野蛮	文明
文明	粗野,蒙昧,野蛮,陋习
趁热打铁	坐失良机
差	对
昔	今
稀溜溜	干乎乎
干乎乎	稀溜溜
公正	偏私,偏向
偏私	公正
俏丽	丑陋
倾诉	倾听
倾听	倾诉,倾吐
漠不相关	责有攸归,休戚相关,无关痛痒
责有攸归	漠不相关
首屈一指	名落孙山
顺口	绕口,拗口
大块文章	要言不繁
要言不繁	大块文章
横眉竖眼	和颜悦色
千奇百怪	千篇一律
沙里淘金	泥沙俱下
包藏祸心	胸怀坦荡
胸怀坦荡	包藏祸心
大有可疑	毫无疑义
任人唯亲	举贤任能,人尽其才
举贤任能	任人唯亲
面面相觑	从容不迫
盛气凌人	必恭必敬,平易近人
必恭必敬	盛气凌人
高歌猛进	裹足不前,垂头丧气
消耗	贮备,储积,积蓄,补偿,积累
积累	消耗,消费,积攒
睹物思人	无动于衷
不经一事，不长一智	痴学不悟
痴学不悟	不经一事，不长一智
领海	公海
一波三折	一帆风顺
将信将疑	深信不疑,信而有徵,信以为真
信以为真	疑神疑鬼,将信将疑
昼	夜
夜	早点,晓,昼
递加	递减
戎马倥偬	安居乐业
一事无成	汗马功劳
汗马功劳	一事无成
反戈一击	同恶相济
同恶相济	反戈一击
踟蹰	果断
高超	凡俗,拙劣
拙劣	高明,高妙,低劣,高超,优秀,卓异
空谷传声	杳无音信
肺腑之言	欺人之谈,花言巧语
欺人之谈	肺腑之言
说一不二	言而无信,出尔反尔,轻诺寡信
刚直不阿	溜须拍马,八面玲珑,阿谀奉承
气势汹汹	和蔼可亲
求乞	施舍
施舍	乞求,募化,求乞
白云苍狗	一成不变
缺欠	长处
同床异梦	同甘共苦,同心同德
神机妙算	束手无策
尾花	题花
题花	尾花
喧宾夺主	客随主便
客随主便	喧宾夺主
干脆	拖沓,犹豫
垂涎欲滴	淡泊寡味
青红皂白	是非分明
见机行事	鲁莽行事,刻舟求剑,变化莫测
零落	茂盛,茂兴
赊购	赊销
赊销	赊购
死不悔改	悔之无及,改邪归正,怙恶不悛
大惊小怪	不足为奇,习以为常
精打细算	大手大脚,粗心大意
守法	违法,平乱
违法	不法,守法
无介于怀	耿耿于怀
心心相印	貌合心离,貌合神离
纵酒	戒酒
戒酒	纵酒
老成持重	少不更事,初出茅庐
真老虎	纸老虎
纸老虎	真老虎
互不相干	遥遥相对
前人	后人
后人	前人
巧妙	蠢笨
蠢笨	聪敏,巧妙,灵巧
急起直追	停滞不前
免	任
任	免
入	舍,出
出	纳,入
枉	正
峨冠博带	衣衫褴褛
原本	简本
简本	原本
集约	粗放
粗放	集约
解约	订约,缔约
缔约	废约,解约
择善而从	无所适从
无所适从	择善而从
担负	担当,推卸
推卸	承担,承当,出让,担负
间断	一连,连绵,断续,连续,持续
持续	中断,间断
侧面	反面,正面
清冷	闷热
闷热	凉爽,清冷,凉快,风凉,凉决
声名狼藉	流芳百世,地望高华
移风易俗	因循守旧
承担	推卸,推脱
推脱	承担
扶危济困	隔山观虎斗,身临其境,落井下石
阳奉阴违	心口如一
如数家珍	不知凡几,一无所知
后今薄古	颂古非今
颂古非今	后今薄古
兽	人
光彩	耻辱,丢人
敲骨吸髓	乐善好施
含沙射影	直截了当
直截了当	含沙射影,拐弯抹角
凄风苦雨	和风细雨
排斥	拉拢,吸引
吸引	排斥
别树一帜	千篇一律
翻然改进	执迷不悟
严惩不贷	姑息养奸
雕虫小技	雄才大略
历史唯物主义	历史唯心主义
历史唯心主义	历史唯物主义
坚信	担心,怀疑
中流砥柱	擎天柱石,随波逐流
旧交	新交
昏聩胡涂	耳聪目明
耳聪目明	昏聩胡涂,闭目塞听
蒙蔽	揭露
揭露	包藏,掩盖,粉饰,蒙蔽,遮掩,隐瞒
乱无章	错落有致
财主	穷人
料事如神	防不胜防
蠢材	天才
含	露
阴险	纯厚,梗直,朴直,善良
百废待举	井井有条
上下其手	光明磊落
采取	放弃
放弃	抉择,占有,采取,采纳,坚持,采用
千真万确	阴错阳差,半信半疑,阴差阳错
半信半疑	千真万确,满腹狐疑,深信不疑
似是而非	具体而微,天经地义
奉为楷模	视如敝屣
愤愤不平	随遇而安
骏马	劣马,驽马
驽马	驽骀,骏马
留有余地	不遗余力
不遗余力	留有余地
树碑立传	口诛笔伐
口诛笔伐	歌功颂德,树碑立传
生效	失效,作数
失效	生效,奏效
为仁不富	为富不仁
为富不仁	为仁不富
空闲	繁忙
繁忙	清闲,闲散,空闲,轻闲,赋闲
先进	后进,落伍
后进	先进
无法无天	安分守己
煮鹤焚琴	怜香惜玉
怜香惜玉	煮鹤焚琴
天崩地裂	万籁俱寂
限制	放手,不拘
放手	限制
无缘	有缘
有缘	无缘
一针一线	斗牛车薪
斗牛车薪	一针一线
寿比南山	寿终正寝
大天白日	半夜三更
陆运	水运
水运	陆运
毛	净
兴	除,衰
将校	军卒
军卒	将校
成家立业	倾家荡产
博古通今	孤陋寡闻,井蛙之见,不学无术
稍息	立正
立正	鞠躬,稍息
心猿意马	心不在焉,一心一意,之死靡它
漆黑	墨黑,雪白
心胸狭窄	豁达大度
根深叶茂	枯木朽株,墙上芦苇
劣势	优势
优势	劣势
相形失色	旗鼓相当
不得要领	提纲挈领
放荡不羁	规行矩步
因材施教	一视同仁
简易	繁难
繁难	简易
火冒三丈	心平气和
解囊相助	一毛不拔
科班出身	半路出家
扬	抑,避
滾烫	冰凉
冰凉	滾烫,滚热,滾热
匹夫有责	敷衍塞责
如日方升	江河日下
动荡不安	天下太平
冰冷	温暖,滚热,火热
火热	冰冷,寒冷
俯首听命	桀骜不驯
头头是道	颠三倒四,语无伦次
外貌	内心
内心	外貌,外表
明哲保身	飞蛾赴火,惹火烧身,同流合污,洁身自好,耻与为伍
行若无事	手忙脚乱,坐立不安
争先恐后	姗姗来迟
少见多怪	多见少怪,屡见不鲜,见怪不怪
多见少怪	少见多怪
心中有愧	问心无愧,心安理得
前方	后方
不仁不义	不念旧恶
不念旧恶	睚眦必报,不仁不义
茫然不解	心领神会
心领神会	茫然不解,通今博古
人心向背	众望所归
众望所归	人心向背,众叛亲离
天昏地暗	天朗气清
天朗气清	风雨如晦,天昏地暗
千言万语	只言片语
只言片语	千言万语
如坐云雾	恍然大悟
丁是丁，卯是卯	藕断丝连
用非所学	学以致用
倒叙	顺叙
顺叙	倒叙
横七竖八	齐齐整整,有条不紊
厌	喜
扎手	顺手
塞翁失马	因福得祸
因福得祸	塞翁失马
阮囊羞涩	腰缠万贯
识途老马	迷路羔羊,初出茅庐
高峰	深谷
深谷	高峰
为民除害	为虎傅翼,草菅人命
草菅人命	为民除害
鸡毛蒜皮	荦荦大端
盟国	敌国
敌国	友邦,盟国
强烈	微弱,柔和
大义凛然	卑躬屈膝
大而无当	娇小玲珑
娇小玲珑	庞然大物,硕大无朋,大而无当
暑	寒
寒	暑
花容月貌	貌若无盐,其貌不扬
得胜	获胜,失败
兔死狗烹	感恩戴德,崇功报德
青眼	白眼
白眼	青眼
酷爱	痛恨,持而
持而	酷爱
名山大川	穷山恶水
深信不疑	疑心生鬼,半信半疑,将信将疑
四分五裂	精诚团结,百川归海
歌功颂德	造谣生事,天怒人怨,口诛笔伐,怨声载道,诅咒、诋,诅咒 诋
偷天换日	正大光明
宣战	媾和
力不胜任	得心应手,力所能及
货次价高	货真价实
货真价实	货次价高,滥竽充数
心腹之患	癣疥之疾
癣疥之疾	心腹之患
秦晋之好	反目成仇
完好无损	伤痕累累,残缺不全
凯旋而归	全军覆没
内行	外行
笼络人心	众叛亲离
费	省
省	费
形影不离	天各一方,若即若离
一不做，二不休	犹豫不决
呕心沥血	粗制滥造
鞭长莫及	如臂使指,近水楼台,不在话下
暴君	圣主
圣主	暴君
出奇制胜	按兵不动
心急火燎	从容不迫
枵腹从公	尸位素餐,穷奢极侈
卑贱	高贵
谬种流传	流芳百世
片言之语	鸿篇巨制
当断不断	当机立断
沉稳	轻佻
洒	捡
捡	洒
敬辞	谦辞
谦辞	敬辞
灵便	笨拙
欢	悲,蔫
悲	喜,欢
字正腔圆	南腔北调
南腔北调	字正腔圆
化合	分解
分解	化合,搀合,组合,合成,挑开
进退自如	进退维谷
进退维谷	游刃有余,进退自如
清闲	繁忙,忙碌
拙嘴笨舌	能说会道
能说会道	笨口拙舌,拙嘴笨舌,笨嘴拙腮
无所不为	安分守己
怒容	喜色
喜色	愠色,怒容,愁容,怒色
蒸发	凝结
朱	墨
墨	朱
鄙陋	渊博
事与愿违	如愿以偿,称心满意,径情直遂,称心如意
东风化雨	暴风骤雨
暴风骤雨	东风化雨,和风细雨
国货	洋货
洋货	国货,舶来品,土产
锦囊妙计	一筹莫展
鸦雀无闻	沸沸扬扬
懒散	紧张
额手称庆	垂头丧气
慷慨解囊	一毛不拔,不拘小节
施加	承受
承受	推却,施加
颓废	振奋
五内如焚	欣喜若狂
自行灭亡	困兽犹斗
老骥伏枥	老气横秋
怜新弃旧	惜玉怜香
浓墨重彩	轻描淡写,刻划入微
弱肉强食	共存共荣,和平共处
以己度人	推己及人
推己及人	以己度人,诿过于人
兵贵神速	缓兵之计
沦落风尘	安家立业
疏浚	淤塞
启运	停运
停运	启运
文言	白话
白话	文言,古文
自花传粉	异花传粉
异花传粉	自花传粉
痛不欲生	欣喜若狂,乐不可支
援助	求援
求援	援助
雄心壮志	雄心勃勃,万念俱灰,心灰意懒
藏垢纳污	涤瑕荡垢
涤瑕荡垢	藏垢纳污
训斥	夸奖
夸奖	责骂,讥嘲,训斥,指斥,责备
蒙昧无知	学富五车
步调一致	各行其是
开场	收场
收场	开场
加官进爵	时乖命蹇
曲突徙薪	临渴掘井
赏罚不明	赏罚分明
藏匿	显露,暴露
显露	藏匿,隐蔽,盖住
只红不专	又红又专
记忆犹新	时过境迁
军官	战士,士兵
战士	军官
男盗女娼	男耕女织
男耕女织	男盗女娼
前怕狼，后怕虎	胆大妄为
口蜜腹剑	苦口婆心
苦口婆心	口蜜腹剑
微贱	显贵,高贵,显赫
不足挂齿	举足轻重
心烦意乱	忐忑不安,心安理得
庸俗	高尚,娴雅,洒脱
厚实	菲薄,单薄
单薄	厚实,粗实
住口	开口
开口	住口
滴水穿石	浅尝辄止
暖衣饱食	饥寒交迫
反躬自问	嫁祸于人,血口喷人,怨天尤人
日	月
月	日
不进则退	勇往直前
墙上芦苇	根深叶茂
放松警惕	常备不懈
常备不懈	放松警惕,临阵磨枪,临渴掘井
分离	聚集,混合,相逢,结合,合并
结合	分开,分离
高大	瘦小,矮小
蹲点	跑面
跑面	蹲点
美观	丑陋
自怨自艾	自鸣得意
自鸣得意	自怨自艾,灰心丧气
软绵绵	硬邦邦,硬绑绑,硬梆梆,雄赳赳
硬梆梆	软绵绵
盖世无双	屡见不鲜
金石为开	无动于衷
网开一面	小肚鸡肠
见义勇为	唯利是图,趁火打劫,见利忘义,隔岸观火
唯利是图	急公好义,见义勇为
还击	进攻
特出	普通
慢性	急性,耐性
急性	慢性
犯而不校	针锋相对
造谣生事	歌功颂德
拯救	迫害
迫害	拯救,保护
曲高和寡	道近易从,下里巴人
眼高手低	量力而行
通宵达旦	一朝一夕
宽宏大量	讨价还价
出类拔萃	碌碌无能,滥竽充数
稳如磐石	东摇西摆
东摇西摆	稳如磐石
毛糙	细致
细致	毛糙,粗疏,马虎,粗拉
民	军,兵,官
不拘小节	缩手缩脚,锱铢必较,慷慨解囊,谨小慎微
生长	消亡
消亡	产生,生长
祖籍	客籍
客籍	祖籍,原籍
老搭档	新伙伴
头伏	终伏,三伏,末伏
三伏	头伏
谨小慎微	敢想敢干,精摹细琢,为所欲为,精雕细刻,小心谨慎,粗心大意,丢三落四,谋定後动,不拘小节
管见	高见
劳动致富	不义之财
不义之财	劳动致富,不谋私利
零	整
整	碎,零
月黑风高	良辰美景,光天化日
良辰美景	月黑风高
金兰之契	酒肉朋友
锐敏	迟钝
方兴未艾	穷途末路,再衰三竭
倾吐	倾听
助人为乐	乘人之危
乘人之危	助人为乐,雪中送炭
由衷之言	甜言蜜语,言不由衷
言不由衷	由衷之言
讳莫如深	无庸讳言,直言不讳
无庸讳言	讳莫如深
有条有理	七颠八倒,乱七八糟,语无伦次
熙来攘往	万籁俱寂
风烛残年	徐娘半老,风华正茂
风华正茂	桑榆暮景,风烛残年
转福为祸	转祸为福
转祸为福	转福为祸
明显	隐约,细微
锣鼓喧天	哑然失声,万籁俱寂
专政	民主
尽力而为	聊以塞责
事不宜迟	来日方长
此伏彼起	风平浪静
外方内圆	外圆内方
疑团莫释	了如指掌
焊接	切割,熔断,割切
熔断	焊接
欣欣向荣	心劳日拙
晴天霹雳	司空见惯
左顾右盼	目不斜视
偷鸡摸狗	光明正大
子孙后代	列祖列宗
列祖列宗	子孙后代
洪福齐天	灭顶之灾
灭顶之灾	洪福齐天
东道	宾客
宾客	东道,主人
驯服	反抗
凋蔽	繁荣
问心有愧	扪心无愧,心安理得
形而上学	辩证法
辩证法	形而上学
瓜分	分享,独吞,独占
独吞	平分,瓜分
一厢情愿	两相情愿
百年不遇	屡见不鲜
坚苦卓绝	轻逸无论
轻逸无论	坚苦卓绝
鬼鬼祟祟	暧昧不明,光明正大,光明磊落,正大光明
预付	赊帐,赊欠
赊帐	预付
搔头弄姿	神态自若
神态自若	搔头弄姿
祸从天降	喜从天降
一日三秋	一刻千金
汹涌澎湃	风平浪静
怨天尤人	乐天安命,反躬自问,反求诸己
率由旧章	除旧布新
葱茏	枯萎
申雪	含冤
含冤	申冤,昭雪,申雪
目光炯炯	黯然失色
蚕食	鲸吞
鲸吞	蚕食
减产	增产,超产
超产	减产
避	扬
生机勃勃	气息奄奄,老气横秋,死气沉沉
顺当	别扭
别扭	顺心,通顺,顺当
可乘之机	无隙可乘
太阳	太阴,月亮
太阴	太阳
略	详
详	略
是非曲直	混为一谈
混为一谈	是非曲直
等闲视之	小题大作
面如土色	奔走相告
门庭若市	形单影只,门庭冷落,门可罗雀
朝令夕改	一如既往,言出法随
楚才晋用	楚弓楚得
楚弓楚得	楚才晋用
休战	开战
开战	休战
幕后	前台
刻舟求剑	见机行事,审时度势,因时制宜
审时度势	刻舟求剑,不识时务
添枝加叶	实事求是
陈陈相固	兴利除弊
肥头大耳	尖嘴猴腮
放虎归山	欲擒故纵
会面	分手
分手	会面,相聚,见面,聚头
心慌意乱	心旷神怡
翻云覆雨	始终不渝,始终如一
来龙去脉	无迹可寻,有头无尾
杀鸡取卵	高瞻远瞩
寻花问柳	正人君子
当之有愧	当之无愧
当之无愧	当之有愧
地心	地表
地表	地核,地心
旁征博引	理屈词穷
笨口拙舌	巧舌如簧,能说会道,灵牙利齿
首鼠两端	干脆利落
干脆利落	首鼠两端
生涩	流畅
旧调重弹	改弦易辙,改弦易张,改弦更张
改弦易张	旧调重弹
多如牛毛	不可多得,凤毛麟角
不可多得	多如牛毛,比比皆是
缄口不言	谈天说地
谈天说地	缄口不言
腹背受敌	各个击破
各个击破	腹背受敌
隐约	明显,清楚,分明
欣然	怅然,戚然
怅然	欣然
人言啧啧	赞叹不已
赞叹不已	人言啧啧
张口结舌	慷慨陈词,振振有辞
慷慨陈词	张口结舌
连用	单用
单用	连用
白圭之玷	十全十美
拂晓	薄暮,黄昏
薄暮	拂晓,傍晚
急公好义	唯利是图
建设	破坏
鉴往知来	鼠目寸光
午夜	正午
正午	午夜,子夜
三从四德	倒行逆施
目瞪口呆	忐忑不安,神色自若,谈笑自若
正颜厉色	和蔼可亲
谈虎色变	面不改色,谈笑自若
不得人心	深得人心,口碑载道
不白之冤	真相大白
转义	本义
本义	转义
兴致勃勃	大煞风景,兴味索然,兴会淋漓
大煞风景	兴致勃勃
禁锢	释放
嫡	庶
庶	嫡
甘	苦
怒目而视	眉开眼笑
合法	非法
非法	合法
天怒人怨	歌功颂德
好吃懒做	贪安好逸,吃苦耐劳
吃苦耐劳	好吃懒做
低级	高级
高级	低级
方丈	沙弥
芸芸众生	超尘拔俗
其味无穷	味同嚼蜡
如履平地	仰之弥高
仰之弥高	如履平地
收敛	肆意,放纵,猖獗,狂放
香花	毒草
毒草	香花
残年	盛年
盛年	残年
歌舞升平	大敌当前,沧海横流,四面楚歌
人多势众	势单力薄,单枪匹马
势单力薄	大气磅礴,人多势众
低贱	宝贵,崇高,贵重,高贵,尊贵
维妙维肖	画虎类犬
荒年	丰年,灾年
无机	有机
有机	无机
细嚼慢咽	狼吞虎咽
狼吞虎咽	细嚼慢咽
尽如人意	左支右绌,大失所望
襟怀坦白	居心叵测,别有用心,心怀叵测
独具只眼	有眼无珠,一无所长
贬值	升值,增值
升值	贬值
彻夜苦读	秉烛夜游
秉烛夜游	彻夜苦读
遮	露
放浪形骸	规行矩步,修心养性
伸	缩
述而不作	别开生面
伏	起
上膘	掉膘
掉膘	上膘
原料	制品,成品
成品	原料
聪明睿智	冥顽不灵
形形色色	如出一辙
义无反顾	畏首畏尾
称王称霸	谦谦君子
洼陷	突起
不慌不忙	—手忙脚,惊慌失措
—手忙脚	不慌不忙
果决	迟疑
迟疑	果决,坚决,寡断
自力更生	坐享其成,仰人鼻息
跃进	爬行
爬行	跃进
左支右绌	绰有余裕,尽如人意
寒色	暖色
暖色	寒色
雅致	粗俗,俗气
同甘共苦	同床异梦
窄小	宽大,巨大
宽大	苛严,宽宥,窄小
穷极无聊	精神饱满
精神饱满	穷极无聊
寻死觅活	欢天喜地
咄咄逼人	和颜悦色,拒人千里,温文尔雅,敬而远之,屈己从人,口角春风
清音	浊音
浊音	清音
飞短流长	仗义直言
仗义直言	飞短流长
千差万别	一念之差
一念之差	千差万别
黑色金属	有色金属
有色金属	黑色金属
给予	接受
有加无已	每况愈下
疏落	茂密,密集
望族	寒门
心慈面善	灭绝人性
灭绝人性	心慈面善,大慈大悲
巧舌如簧	笨口拙舌
出人意表	不出所料
自强自力	城下之盟
领袖	群众
七情六欲	四大皆空
摩拳擦掌	按兵不动
直线	折线
折线	直线
叹为观止	海底捞针
积水成渊	杯水车薪
杯水车薪	积水成渊
间接	直接
生财之道	投机倒把
贺词	吊词,悼词
悼词	贺词
引以为荣	羞与为伍
羞与为伍	引以为荣
山珍海错	粗茶淡饭,淡饭清茶
兔死狐悲	幸灾乐祸
厌烦	酷好,耐烦,喜欢
珠围翠绕	荆钗布裙
义不容辞	袖手旁观,推三阻四
贵族	平民,君主,庶民
美中不足	十全十美
下马	上马
上马	下马
钢筋铁骨	弱不胜衣
怀柔	镇压
镇压	安抚,怀柔,反抗,平抑,狭小窄小苛严
张扬	隐瞒
隐瞒	告诉,揭露,提醒,坦白,公布,戳穿,张扬
凑拢	分散
深透	肤浅
金玉满堂	富可敌国,家徒四壁
家徒四壁	金玉满堂,富可敌国,家财万贯,富甲一方
崭露头角	默默无闻,不露圭角
僵硬	刚硬,柔软,灵活
柔软	坚硬,僵硬
冒名顶替	名副其实
流言蜚语	金玉良言
金玉良言	流言蜚语
吊丧	贺喜
贺喜	吊丧,报丧
温柔敦厚	出言不逊,尖酸刻薄
日前月腹	家给人足
前所未闻	司空见惯
暗示	表明,明说
明说	暗示
百端待举	百废待兴
百废待兴	百端待举
下1	上
芳香	恶臭
恶臭	清香,芳香
出征	班师
班师	出师,出征
空前绝后	比比皆是,承前启后
排外	媚外
媚外	排外
无可奈何	诚心诚意
诚心诚意	无可奈何,冷言冷语,假仁假义
闻风丧胆	泰然自若
拘押	释放
敷设	拆除
拆除	修复,设立,敷设
签发	签收
签收	签发
得到	失掉
失掉	得到
一了百了	没完没了,依然如故
功勋	罪恶
罪恶	功勋,正义
千丝万缕	蛛丝马迹,一刀两断
视死如归	贪生怕死,成仁成义,苟延残喘
反求诸己	苛求于人,怨天尤人
苛求于人	反求诸己
情深似海	薄幸堪惊,恨入骨髓
恨入骨髓	情深似海
懒	勤
勤	懒,惰
轻慢	恭敬,爱戴,敬重
百感交集	无动于衷
瓮中之鳖	漏网之鱼
漏网之鱼	瓮中之鳖
小户	大户
大户	小户
淡月	旺月
旺月	淡月
心怀鬼胎	正大光明
屈膝投降	宁死不屈
触类旁通	一窍不通
色厉内荏	表里如一,名副其实
安营	拔营
拔营	扎营,安营
往	来,返
滔滔不绝	哑口无言,避而不谈,默默不语
火上浇油	釜底抽薪
团体	个人
荒歉	丰收
名列前茅	榜上无名,名落孙山
避实就虚	以卵击石
以卵击石	避实就虚
蛟龙失水	蛟龙得水
瞬息之间	年深日久
尊老爱幼	奸淫掳掠
募化	施舍
保卫	攻击,抵御,侵犯
滑腻	粗糙
攒	花
花	攒
间或	时常
时常	间或
七步之才	呆头呆脑
丢三落四	谨小慎微
信赏必罚	既往不咎
既往不咎	信赏必罚
中心	周围,边缘
风凉	闷热
不由分说	无理取闹
谦和	傲慢
傲慢	谦和,谦恭,谦逊
豺狼成性	乐善好施
大灾三年	风调雨顺
风调雨顺	狂风暴雨,大灾三年
暂停	久留
久留	暂停
征聘	应聘
应聘	征聘
割席分座	海内存知己，天涯若比
海内存知己，天涯若比	割席分座
棋逢对手	棋高一着,略胜一筹
棋高一着	棋逢对手
蜷缩	舒展,伸直,伸展
伸直	蜷缩,弯曲
缴	收
调兵遣将	按兵不动,班师回朝
悠闲自得	疲于奔命
前赴后继	临阵脱逃
意气风发	神色沮丧,万念俱灰
斗鸡走狗	日理万机
望风披靡	每战皆北,所向无敌
仓皇	沉着
杀人不见血	与人为善
与人为善	杀人不见血
不可名状	一语破的
赞不绝口	令人作呕
别致	寻常,普通
独出心裁	千篇一律,如法炮制
简装	精装
正旦	除夕
注重	轻视
退休	在职
难兄难弟	恩断义绝
恩断义绝	难兄难弟
爱屋及乌	爱莫能助
爱莫能助	爱屋及乌
与虎谋皮	行之有效
上面	下面
下面	上面
违法乱纪	遵纪守法,奉公守法
春风和煦	春寒料峭
笑里藏刀	心口不一
心口不一	笑里藏刀
自杀	他杀
他杀	自杀,谋杀
焦头烂额	万事亨通
安不忘危	麻痹大意,乐不思蜀
乞	赐
赐	乞
乱点鸳鸯	成人之美
粗枝大叶	细针密缕,小心翼翼
年老体衰	宝刀不老
宝刀不老	年老体衰
千山万壑	一马平川
饥不择食	挑肥拣瘦
浅近	深奥
得鱼忘筌	饮水思源
天长日久	稍纵即逝
稍纵即逝	天长地久,天长日久
和睦相处	相煎何急
相煎何急	和睦相处,伯歌季舞
历历在目	昏天黑地
不甘示弱	甘拜下风,不甘雌服
唯命是从	桀骜不驯
平淡无味	脍炙人口
脍炙人口	平淡无味
不可捉摸	一目了然
欢歌笑语	长吁短叹
长吁短叹	欢歌笑语
徐娘半老	人老珠黄,风烛残年
有的放矢	无的放矢,对牛弹琴
以身殉职	玩忽职守
死气沉沉	热气腾腾,轰轰烈烈,生龙活虎,朝气蓬勃,龙腾虎跃,生气勃勃,生机勃勃
面目可憎	眉清目秀,眉目如画,仪容可爱
杂牌军	正规军
正规军	游击队,杂牌军
大局	局部,小局
局部	整体,通盘,大局
居心叵测	推心置腹,襟怀坦白
五内俱焚	心花怒放
太平盛世	兵连祸结,兵荒马乱,家破人亡
无与伦比	不相上下,等量齐观
危害	维护
维护	破坏,败坏,危害
a节省节约a	节省
恩赐	乞求
欢庆	哀悼
哀悼	庆贺,祝贺,欢庆
安贫乐道	不甘食贫,愤世嫉俗,为所欲为
劈头盖脸	和风细雨
脱胎换骨	旧瓶新酒,依然如故,执迷不悟
罚	赏
赏	罚
钩心斗角	肝胆相照,披肝沥胆
不寒而栗	临危不惧,无所畏惧
热热闹闹	冷冷清清
首席	末座
末座	首席
魑魅魍魉	志士仁人
尊敬	侮慢,侮辱,轻蔑
勤勉	懒惰
有所作为	无所事事
漏网	落网
全	偏,残
风雨如晦	天朗气清
绣花枕头	真才实学
真才实学	绣花枕头,不学无术
纵横交错	井井有条
生龙活虎	人困马乏,死气沉沉
人困马乏	生龙活虎
乳臭未干	后生可畏
后生可畏	乳臭未干
声色狗马	流芳百世,名垂青史
惹是非	守规矩
守规矩	惹是非
重整旗鼓	背水一战,偃旗息鼓,一蹶不振
飞扬跋扈	平易近人
交臂失之	机不可失
机不可失	交臂失之,失之交臂
平步青云	穷困潦倒
一得之见	真知灼见
任其自然	循规蹈矩
小人	君子
君子	小人,圣人巨人
形式	内容
内容	形式
回天之力	回天乏术
深层	表层
表层	深层
喜怒哀乐	心平气和
任重道远	无所作为
惴惴不安	心安理得
面不改色	谈虎色变,面红耳赤
头破血流	马到成功
海内	海外
理想	现实
现实	空想,幻想,理想,梦幻
简洁	啰唆,冗长
聪慧	愚蠢,愚拙
年末	年初
息息相关	漠不关心
泾渭不分	泾渭分明
面	点,背,里
背	面,腹,当众,向
残羹冷炙	山珍海味
聪敏	愚笨,蠢笨
水滴石穿	虎头蛇尾
阴错阳差	千真万确
泥古不化	革故鼎新
侵略	抵抗
抵抗	投降,侵略
单程	来回,往返
往返	单程
瞠目结舌	应对如流
应对如流	瞠目结舌
凉快	温暖,闷热,暖和
本质	本体,现象,表面
护	毁
毁	护,誉
仰人鼻息	自力更生,独立自主,独当一面
伟人	凡人
优厚	菲薄
瑜	瑕
瑕	瑜
世代相传	旷古绝伦
旷古绝伦	世代相传
混乱	井然
井然	混乱,紊乱
置之脑后	言犹在耳
言犹在耳	置之脑后
生花妙笔	平铺直叙,平淡无奇,波澜起伏
天差地远	不相上下,大同小异
火中取栗	坐享其成
主角	下手,配角
配角	主角
应	求,呼
呼	应,吸
自用	公用
公用	自用,私用
背道而驰	异途同归,殊途同归,并肩前进
冷言冷语	语重心长,诚心诚意
一无可取	完美无缺
魂牵梦萦	大梦初醒
大梦初醒	魂牵梦萦
降落	起飞,着陆,降下,升空,升起
升起	降落
固步自封	停滞不前,一往无前
一往无前	故步自封,溜之大吉,固步自封
开业	停业,营业
没落	腾达,兴旺
不偏不倚	耸人听闻,畸轻畸重
吸	呼
再衰三竭	方兴未艾
初生牛犊	惊弓之鸟
惊弓之鸟	初生牛犊,初生之犊
童年	少年,中年,暮年
暮年	童年
矫柔造作	天造地设
休戚相关	漠不相关,漠不关心
清除	扩散
扩散	清除
新教	旧教
旧教	新教
以一警百	杀一儆百
发慌	镇静,塌实
塌实	浮躁,浮漂,发慌
紧迫	充裕
疑神疑鬼	信以为真
补益	贻害
贻害	补益,造福
粗衣粝食	山珍海味
不厌其详	语焉不详
语焉不详	彰明较著,不厌其详
清脆	浑厚,沙哑,嘶哑
独木难支	砥柱中流
砥柱中流	独木难支
超凡入圣	狗彘不若,百无一是
百无一是	超凡入圣
留鸟	候鸟
候鸟	留鸟
因地制宜	一成不变
奢华	俭朴,俭约
俭朴	奢侈,豪华,奢华
工人阶级	资产阶级
时兴	过时
优越	恶劣,平凡
争长论短	甘拜下风
支取	储存
溜之大吉	一往无前
创巨痛深	欣喜若狂
咎由自取	回头是岸
更动	照旧
貌合心离	心心相印
水泼不进	见缝插针
取得	失去
暴跳如雷	平心定气,心平气和,平心易气,感情用事
高涨	低落
惨绝人寰	仁至义尽
狂风暴雨	风调雨顺
滴水不漏	漏洞百出
旁支	嫡系
不露圭角	崭露头角,锋芒毕露
空头支票	一诺千金
功绩	罪行,罪过,过错
过错	功绩
电光石火	旷日持久
岌岌可危	安然无事,安如泰山,稳如泰山
颠倒黑白	实事求是
鲜明	隐晦
隐晦	鲜明,模糊,显着
各行其事	同舟共济
讨伐	安抚,挞伐
单枪匹马	人多势众
气喘吁吁	心平气和
发财	受穷
受穷	发财
铁案如山	屈打成招
不绝如缕	牢不可破
简缩	扩展
无穷	有限
有限	无穷,无限
破裂	弥合
弥合	破裂
不疾不徐	过犹不及
过犹不及	恰如其分,适可而止,不疾不徐
委靡不振	慷慨激昂,斗志昂扬
管	惯
惯	管
放肆	检点,拘谨
雄心勃勃	万念俱灰,雄心壮志,心灰意懒
旦	夕
如胶如漆	反目成仇
因循坐误	分秒必争
近在眉睫	远在天边
一本万利	徒劳无功
法不阿贵	贪赃枉法
无耻之尤	廉洁奉公
割切	焊接
凋落	茂盛
改良	守旧
守旧	改革,革新,开明,改良,改进,开通
昭雪	含冤
情同骨肉	势不两立
必不可少	多此一举
和气	粗暴,严峻,杀气,利害
游击队	正规军
出尔反尔	说一不二,始终如一
涕泗滂沱	眉开眼笑
灰暗	明朗
情急智生	一筹莫展
嫌恶	喜爱
倒伏	挺立
挺立	弯曲,倒伏
幻想	现实
区分	混同
奇	偶
群	干
死里求生	坐以待毙
井浅河深	门当户对
门当户对	井浅河深,门户相当
通好	绝交
郎才女貌	无德无才
无德无才	郎才女貌
丹凤朝阳	怀才不遇
增进	减退
减退	增进
悦耳	难听
畅销	滞销
滞销	脱销,畅销
造福	祸害,贻害,酿祸
杀生	放生
放生	杀生
动乱	安宁,升平,安定
暴政	善政,仁政,德政,虐政
仁政	苟政,暴政
定期	活期
活期	定期
金戈铁马	天下太平,轻歌曼舞,玉帛笙歌
幼	长,成
成	败,幼,砸
鸡犬不宁	莺歌燕舞,夜阑人静
一言不语	娓娓动听
阴冷	和煦,暖和
紧凑	松散,空隙
背水一战	重整旗鼓
千载一时	俯拾即是
听而不闻	有闻必录
有闻必录	听而不闻
登峰造极	屡见不鲜
言无二价	欺行霸市
欺行霸市	言无二价
借题发挥	大题小作
浪子回头	屡教不改
横冲直撞	首尾相应
首尾相应	横冲直撞
大气磅礴	势单力薄
出师	班师,回师
人人自危	高枕无忧
歧路亡羊	改邪归正
改邪归正	怙恶不悛,歧路亡羊,死不悔改,执迷不悟
叫苦连天	眉开眼笑
深恶痛疾	情深意重
情深意重	深恶痛疾
兵强马壮	兵微将寡,赤手空拳,兵多将广
成人之恶	成人之美
轻歌曼舞	金戈铁马
残败	繁盛,茂盛
有气无力	精神焕发
精神焕发	没精打彩,有气无力,精神奕奕
娶	嫁
嫁	娶
后天	先天
先天	后天
人民	敌人,政府
郁悒	愉快
嬉皮笑脸	一本正经,不苟言笑
昏迷	清醒,苏醒
小气	大方
按期	超期
超期	按期
地广人稀	弹丸之地,地狭人稠,摩肩接踵,十室九空
摩肩接踵	地广人稀
出何典记	言之有据
精益求精	粗制滥造
缺乏	丰富,充足
触景生情	无动于衷
下碇	起锚
起锚	抛锚,下碇
不衫不履	规行矩步,衣冠楚楚
升平	动乱
前卫	后卫
相依为命	各奔前程
有方	无方
无方	有方
惩处	嘉勉,弹刻,嘉奖
嘉奖	惩处,惩罚
寿辰	忌日
脱节	连接,连贯,联系
老师	学生
百川归海	四分五裂
寿	夭
夭	寿
误	正
出生入死	贪生怕死
时乖运蹇	财运亨通
琳琅满目	疮痍满目
疮痍满目	琳琅满目
丰美	枯萎
廉政自守	诛求无已
推翻	创立,扶植,建立,扶直
建立	废止,废除,推翻,打倒
勤学苦练	偶一为之
繁茂	稀疏,干枯,繁密
毫厘不爽	张冠李戴
秀丽	丑陋
狼狈不堪	从容不迫
整个	部分
迫不得已	何乐而不为,心甘情愿
何乐而不为	迫不得已
塌	撑,支
撑	塌
舍	取,入
时来运转	生不逢时
暴戾恣睢	慈眉善目
源源不绝	断断续续
交出	接收
接收	递送,发出,交出
犬牙交错	整整齐齐
严肃	随和,滑稽,轻浮,活泼
螳臂当车	泰山压卵
泰山压卵	螳臂当车
压服	说服
说服	压服
亲眼目睹	视若无睹
视若无睹	亲眼目睹
痛恨不已	喜闻乐见
尖锐	迟钝
露脸	丢脸
丢脸	争脸,丢丑,体面,难看,露脸
做东	做客
做客	做东
自家	人家
人家	自家
朝发夕至	千里迢迢
如获至宝	如丧考妣
清贫	阔绰
独占	摊分,共管,瓜分
孤立	联合,联系
老牛舐犊	深恶痛绝
千军万马	一兵一卒,一成一旅
一成一旅	千军万马
迎头赶上	甘拜下风
乡	城
城	乡
心狠手辣	心慈手软,心慈面软
以内	以外
以外	以内
分居	同居
同居	并处,分居
顾虑	放心
失利	取胜
取胜	失利
痴心妄想	切中事理
加紧	放松
压	抬
抬	压
卒	生
小鸟依人	深恶痛绝
形影相随	举目无亲
百无一存	箭不虚发
长篇大论	断简残编
噤若寒蝉	口若悬河,侃侃而谈
一得之功	丰功伟绩
精神	物质,灵魂,不倦,疲劳
物质	精神
正襟危坐	威义不肃,摇头摆脑
威义不肃	正襟危坐
在所不惜	敝帚自珍
肥田沃土	寸草不生
诘屈聱牙	琅琅上口
亲人	仇人
仇人	恩人,亲人
扩军	裁军
裁军	扩军
劫后余生	吉人天相
心灵手巧	笨手笨脚
笨手笨脚	手疾眼快,心灵手巧
十拿九稳	漏洞百出
维持	改变,整顿
改变	保持,维持,依旧
奴才	主子
主子	奴才
想入非非	四平八稳
素不相识	一见如故
感慨系之	无动于衷
面目一新	旧态依然,依然如故,变化多端
杀人如麻	救死扶伤
纸醉金迷	粗茶淡饭
避而不谈	滔滔不绝
拔高	压低
压低	拔高
不谋私利	不义之财
声泪俱下	笑容可掬,心花怒放
沉痛	高兴,欢快
欢快	不快,沉痛,哀婉
体贴入微	漠然置之
遇险	脱险
脱险	遇险
关怀备至	漠不关心
名垂青史	流芳百世,声色狗马
黔驴之计	力大无穷
裁减	增补
增补	裁减,删减,删节
一隅之见	真知灼见,远见卓识
新秀	元老
元老	新秀
男欢女爱	争风吃醋
势均力敌	天差地别,寡不敌众,众寡悬殊
辅音	元音
元音	辅音
经销	采购
晓行夜宿	游山玩水
游山玩水	晓行夜宿
关押	释放
片纸只字	累牍连篇,片言只语
眉飞色舞	垂头丧气
局促	打怵,宽绰
主攻	助攻
助攻	主攻
前车可鉴	覆辙重蹈,重蹈覆辙
虚怀若谷	自命不凡,目空一切,刚愎自用,夜郎自大,目空四海,目无余子,目中无人,旁若无人,自以为是
目空一切	顾盼自雄,虚怀若谷
缔结	取缔
取缔	缔结
立此存照	空口无凭
心狠手毒	心慈手软
斩尽杀绝	养虎遗患,剿抚兼施
无拘无束	局促不安
局促不安	无拘无束,怡然自得,倜傥不羁
眼观六路	闭目塞听
心直口快	闪烁其辞,直言不讳
不知不觉	惊天动地,先知先觉
暴虐	仁慈
强词夺理	理直气壮,入情入理,不近情理
泪如雨下	眉开眼笑
闻所未闻	司空见惯
求战	求和
地狭人稠	地广人稀
民不聊生	安居乐业,国泰民安,家给人足
热心	冷漠,冷血
不远千里	近在咫尺
半途而废	坚持不懈,坚持到底,一曝十寒,贯彻始终,锲而不舍
人尽其才	任人唯亲,责重事繁,大材小用
千方百计	束手无策
绰绰有余	捉襟见肘
炎	凉
戛然而止	油然而生
黑洞洞	亮堂堂
藐视	重视,敬爱
怒不可遏	心平气和
破约	守约
守约	失信,破约
手疾眼快	笨手笨脚
移山倒海	温文尔雅
繁多	稀少
退却	前进,挺身
前进	倒退,退却,停留
醉	醒
变温动物	温血动物
温血动物	变温动物
贪污腐化	清正廉洁
清正廉洁	贪污腐化
装	拆,卸
吝啬	大方,慷慨
举棋不定	坚定不移,当机立断
内勤	外勤
外勤	内勤
一改故辙	一成不变
游移不决	当机立断
表扬	批评,讥笑,诘责,斥责,叱责
搅浑	澄清
轰轰烈烈	偃旗息鼓,死气沉沉
滾热	冰凉
制造冤案	洞烛其奸
藏污纳垢	藏龙卧虎
落榜	不第,登第
登第	落榜
飞黄腾达	江河日下,一落千丈
死有余辜	功标青史,死得其所
死得其所	死有余辜
反动	进步,革命
绿	红
红	绿
一言既出，驷马难追	言而无信
冰点	沸点
沸点	冰点
睚眦必报	大度包容,不念旧恶
灵巧	蠢笨,笨拙,呆板,粗笨,笨重,拙笨
承前启后	空前绝后
连种	轮种
轮种	连种
胜诉	败诉
败诉	胜诉
解职	复职
从前	此刻,现在,目前
现在	从前,那时
如雷贯耳	无名小卒
暂时	长期,永久,长久
白壁微瑕	白璧无瑕
徇情枉法	守正不阿,铁面无私,大义灭亲
恶化	好转,改善
好转	恶化
残忍	怜恤,仁慈,怜悯
下马观花	细心吟味,蜻蜓点水
山盟海誓	见异思迁
不相往来	息息相通
酒色之徒	正人君子
完好	残破,破损,破碎
三十六策，走为上策	坐以待毙
功标青史	死有余辜
支吾其词	侃侃而谈
面目全非	本来面目,依然如故
如兄如弟	如狼似虎
丢人	光彩
悲欢离合	平淡无奇
必有一失	愚者千虑，必有一得
德高望重	德薄能鲜,无名鼠辈
打躬作揖	横行霸道
鸣锣开道	无声无息
听其自然	因势利导
瑜不掩瑕	瑕不掩瑜
急风暴雨	和风细雨
举手之劳	难于登天
崇山峻岭	一马平川
空瘪	饱满
鸟语花香	穷乡僻壤
稀客	常客
常客	稀客
血口喷人	反躬自问
孤苦伶仃	天伦之乐
灵牙利齿	笨口拙舌
气贯长虹	气息奄奄
不入虎穴，焉得虎子	胆小如鼠
综合	分析
分析	总结,综合
众口交誉	啧有烦言
营私舞弊	正直清廉,徇私舞弊
近忧	远虑
远虑	近忧
英姿焕发	獐头鼠目
气冲斗牛	心平气和
白头偕老	分道扬镳
协调	纷争,失调
失调	协调,闹争
咫尺之间	天涯海角
人老珠黄	徐娘半老
苦大仇深	养尊处优
丧魂落魄	镇静自若
乞浆得酒	借贷无门,得不偿失
疑心生鬼	深信不疑
冷清	热闹
五光十色	色彩单一
道不拾遗	打家劫舍
一箭之遥	天涯海角
搅混	澄清
千岩万壑	一马平川
卵与石斗	以一当十
选贤任能	招降纳叛
早霞	晚霞
晚霞	早霞,朝霞
青云直上	困处泥涂,一落千丈
不期而然	意料之中
振振有词	闭口不言,理屈词穷
神经过敏	麻木不仁
按劳分配	无功受禄
得道多助	失道寡助
失道寡助	得道多助
百步穿杨	无的放矢,漫无目标
下降	上升
蹈常袭故	除旧布新
化	冻,凝
凝	化
得意洋洋	垂头丧气
冰雪消融	冰天雪地
报忧	报喜
报喜	奔丧,报忧
难偿所愿	如愿以偿,天从人愿
怒气冲天	欣喜若狂
序曲	尾声
家财万贯	贫无立锥,一贫如洗,家徒四壁,家贫如洗
月底	月初
健全	残障,残废,欠缺
欠缺	十全,健全
驾轻就熟	半路出家
忘却	记挂,记忆
记挂	忘却
装模作样	本来面目
欢＃	欢送
踽踽独行	成群结队
自由诗	格律诗
格律诗	自由诗
入帐	销帐
认贼作父	泾渭分明,大义灭亲
雕梁画栋	蓬门荜户
敦厚	奸诈
凶多吉少	吉星高照
交口称誉	啧有烦言,众矢之的
将功补过	将错就错
雾里看花	洞若观火,一目了然
德薄能鲜	德高望重,德才兼备
摇身一变	一成不变
激流勇进	急流勇退
顶天立地	特立独行,瞻前顾后,低头哈腰
倚老卖老	老当益壮
拒人千里	三顾茅庐,咄咄逼人
原因	结果
缺德少才	才高行洁
义无返顾	裹足不前
梢	根,本
前无古人	司空见惯
新陈代谢	停滞不前
激动	冷静,平静,镇定
发迹	沦落,破产
破产	发迹
国色天香	其貌不扬
合成词	单纯词
单纯词	合成词
熄	着
抑强扶弱	以强凌弱
石破天惊	默默无闻
无机可乘	有机可乘
刻鹄类鹜	跃然纸上
附录	正文
棘手	难办,顺手
立杆见影	海底捞月
阻拦	放行
亲与其事	坐观成败
温情脉脉	冷若冰霜
报恩	报仇,复仇
复仇	报恩
万古不变	万象更新
笨鸟先飞	坐以待毙
中举	落第
落第	及第,中举
充足	短缺,缺乏
尖酸刻薄	宅心仁慈,温柔敦厚
决一雌雄	不分胜负
头等	次等
次等	头等
联合	孤立,分散
歉	丰
丰	歉
起动	关闭
绕口	顺口
静若秋水	震撼人心
春风得意	向隅而泣
惹火烧身	明哲保身
暗室欺心	不欺暗室
不欺暗室	不愧屋漏,暗室欺心
删节	增补
名存实亡	名不副实,名副其实
诿过于人	推己及人
功和	挑拨
私而忘公	公而忘私
昭然若揭	真伪莫辨
一团漆黑	了如指掌
远见卓识	一隅之见
愤世嫉俗	众醉独醒,卓然自立,随俗沉浮,安贫乐道
误点	准时,正点
手不释卷	不学无术
温顺	暴戾,倔强,暴躁,粗暴
扪心无愧	问心有愧
陆	水
阴差阳错	千真万确
感慨万千	无动于衷
少量	大批,大量
边疆	内地
召集	遣散,应徵,解散,徵召
遣散	赶走,召集,徵集
离散	团圆,凝结,团聚,完聚
俯视	仰望,仰视
大发雷霆	平心静气
鸿毛	泰山
泰山	鸿毛
惟妙惟肖	画虎类犬
理屈辞穷	义正辞严
义正辞严	理屈辞穷,理屈词穷
作威作福	仁至义尽,俯首贴耳
假嗓	真嗓,本嗓
真嗓	假嗓
艰苦奋斗	花天酒地
花天酒地	面壁下帷,艰苦奋斗
广土众民	立锥之地
刺刺不休	沉默寡言
刀山火海	风平浪静
赊欠	预付
大智大勇	有勇无谋
深得人心	不得人心
惨淡经营	无所用心
亲痛仇快	同仇敌忾
山清水秀	穷山恶水
咬牙切齿	笑容可掬
仇	情,友,恩
低人一等	高人一等
畅通	阻碍,阻隔,阻塞,淤滞,梗阻,闭塞,窒碍
简朴	奢侈,华丽,豪华
小题大做	大题小做,轻描淡写
横眉立眼	和颜悦色
当选	录取,落选
厚颜无耻	自惭形秽,忠厚老实
故杀	误杀
误杀	故杀
血流漂杵	兵不血刃
切割	焊接
进退有常	进退失据
轻装简从	前呼后拥
诅咒、诋	歌功颂德
七窍生烟	心平气和
隐约其辞	直言不讳
甘居人后	力争上游
归顺	背叛,反叛
解散	纠合,集合,召集,成立
集合	解散
人仰马翻	人强马壮
韧	脆
脆	韧
风云突变	一成不变
毅然决断	踌躇不前
山南海北	近在咫尺
枪林弹雨	和平共处
奇花异草	平淡无奇
除	兴
因祸得福	乐极生悲
发出	接收,收回
精明强干	碌碌无为,糊涂颟顸
挥	招
招	挥
无家可归	安居乐业
胆小	勇敢
陋俗	新风
见几而作	鲁莽行事
惨无人道	仁至义尽
伤风败俗	高风亮节
撤销	设立,制订,设置
设置	撤销
朴素	奢侈,华丽
疑惑	明白,断定
饮泣吞声	捧腹大笑,前仰后合,嚎啕大哭
辅车相依	反目成仇
游移	坚定
兵来将挡，水来土掩	束手无策
失时	及时,得时
蠢蠢欲动	按兵不动
名扬四海	臭名远扬
眉目如画	面目可憎,其貌不扬,仪容可爱
荒凉	繁华
无所不有	一无所有,比比皆是
难如登天	易如反掌,轻而易举
雨过天青	大雨如注
大雨如注	雨过天青
敲诈勒索	拾金不昧
通都大邑	穷乡僻壤
狡诈	淳厚,憨厚,老实
淳厚	狡诈,浇薄
贻害无穷	斩草除根
冲口而出	守口如瓶
仁人志士	害群之马
嫌贫爱富	惜老怜贫
享福	吃苦,受罪,遭罪
面红耳赤	面不改色
中国画	西洋画
西洋画	中国画
近在眼前	远在天边
日不暇给	无所事事
浮漂	塌实
忘其所以	谦虚谨慎
对外开放	闭关自守
口译	笔译
笔译	口译
旗帜鲜明	模棱两可
进寸退尺	得寸进尺
不名一钱	腰缠万贯
发人深省	执迷不悟,迷途知返
节节败退	所向披靡,捷报频传
无限	有限
逆来顺受	针锋相对,以牙还牙
捶胸顿足	眉开眼笑
不忮不求	多多益善
东方	西方
西方	东方
良莠不齐	泾渭分明
称兄道弟	行同陌路
不近情理	强词夺理,通力合作
卑鄙龌龊	高风亮节
吃一堑，长一智	重蹈覆辙
馨香祷祝	切齿咒骂,口是心非
擎天柱石	中流砥柱
顺耳	逆耳,刺耳
见所未见	司空见惯,独一无二
披坚执锐	赤膊上阵
巧立名目	实事求是
私下	公开
金迷纸醉	饥寒交迫
珍视	轻视,蔑视
剜肉补疮	事半功倍
望尘莫及	后来居上
该	还
流浪	定居,安居
较短论长	同日而语
炉火纯青	半路出家,羽毛未丰
安常守故	推陈出新
借帐	还帐
钳口不言	口若悬河
明确	含混,含糊
天长地久	稍纵即逝
红日三竿	半夜三更
虚度光阴	马不停蹄
起伏跌宕	平铺直叙
喜讯	噩耗
扶起	推倒,放倒
门前冷落	熙熙攘攘
无孔不入	无懈可击
腐败	新鲜
干净利落	拖泥带水
椎心泣血	眉开眼笑
士兵	军官,将军,将领
伸展	蜷缩,收缩
大材小用	小材大用,人尽其才
披头散发	眉清目秀
杀人越货	舍己为人
掩耳盗铃	开诚布公
扩大	缩小
哑然失声	锣鼓喧天
聪明才智	冥顽不灵
趋炎附势	刚正不阿
凝固	融化,溶化
溶化	凝固
步步为营	轻举妄动,扬扬无备
一掷千金	一毛不拔,爱财如命
名满天下	声誉大增,身败名裂
争执	和解
来者不拒	拒之门外,门无杂宾
片甲不回	大获全胜
昂扬	低落,懊丧,压抑,低沉
懊丧	昂扬,振作
点头	摇头
摇头	点头
浅显	深奥,艰深,难解,古奥
古奥	浅显
大有作为	无所作为
摧枯拉朽	坚不可摧
覆水难收	鸾飘凤泊,破镜重圆
抑制	放纵,兴奋,促成,节制
独一无二	见所未见,无独有偶
求同存异	求全责备
以逸待劳	疲于奔命
抽象	具体
白日做梦	脚踏实地
杂乱	整齐
死路	活路,生路
生路	熟路,死路
夜宵	早茶
早茶	夜宵
浓密	稀疏,稀薄
智勇双全	有勇无谋
郁郁不乐	兴高采烈
胸中无数	张皇失措,作舍道傍,心中有数
书香门第	蓬门荜户
以德报恩	恩将仇报
法网难逃	逍遥法外
物换星移	一成不变
功昭日月	罪不容诛,罪大恶极
死去活来	不痛不痒
艰深	浅显,平易,浅易
浅易	艰深
一技之长	一无所长
消失	存在,产生,呈现,出现,降临,泛起,浮现,留存,失落,显现
公报私仇	克己奉公
姹紫嫣红	残花败柳
单刀赴会	群策群力
争	让
让	抢,争
降龙伏虎	唯唯诺诺
一心二用	心无二用
略胜一筹	棋逢对手
五彩缤纷	一成不变
莺歌燕舞	鸡犬不宁
残缺	无缺,完整
望眼欲穿	左右逢源
双管齐下	另起炉灶
流连忘返	迷途知返
意气扬扬	灰心丧气
完聚	离散
妥协	斗争,申辩,决裂
斗争	妥协
铤而走险	畏缩不前
稠	稀
指鹿为马	循名责实,实事求是
追求	追逐
追逐	追求
经验	教训,无知
无知	博学,经验
孤独	温暖,热闹
贪心	不满,满足
满足	贪心,渴望
通俗	精粹,高雅
寂寞没有反义词,可以参考孤独的反义词	寂寞
焦急	耐心,镇定
救援	无助,戕害
无助	救援
奇观	平淡
嫉妒	羡慕,佩服
佩服	嫉妒,厌恶
高耸	低平,低垂,低矮
低垂	高昂,低平,高耸
粗壮	孱弱,瘦弱,纤细,纤弱
逍遥	拘束
凄凉	繁荣,肃杀
真挚	虚假,虚伪
果然	竟然
竟然	果然
亲热	冷淡
散乱	均匀
偏僻	繁华,热闹
立即	犹豫
见微知著	原始见终
原始见终	见微知著
哀婉	欢快
遥远	咫尺,附近
咫尺	遥远
顽强	脆弱
狂风大作	风平浪静
隆重	轻率,低调
低调	隆重,高调
秘诀	常理
常理	秘诀
正确	差错,舛讹,错误,不对,舛错
蛰伏	蠕动,雄飞
雄飞	蠢动,雌伏,蛰伏
急切	迟缓,犹豫
惧怕	泰然
泰然	惧怕
慢悠悠	急匆匆,慢腾腾
隐藏	败露,露出,掩盖,披露,显示,暴露,表现,展现
担忧	放心
贪婪	知足
知足	贪婪,不满
注意	忽略,旁骛
旁骛	注意
分化	同化,统一
保存	删除,销毁
销毁	保存
删除	保存
谨慎	莽撞,马虎,冒失
晶莹	浑浊,晦暗
忽然	悠然
悠然	忽然
赶快	缓慢
狰狞	慈祥
肃穆	喧哗
喧哗	肃穆,安静
执意	犹豫
惊诧	平静
倔强	温顺,驯顺
奇巧	平庸
学习	玩耍
玩耍	学习
情	仇
客	主
可能	应该,一定
一定	倘若,未必,可能
起早	贪黑
贪黑	起早
寒冬腊月	盛夏酢暑
盛夏酢暑	寒冬腊月
浑身	全身
全身	浑身
年老	年轻,年幼
年幼	年老
安	乱,危
昂	俯
俯	昂,仰
安和	纷扰
纷扰	安宁,安和
安放	移动
移动	安放
挨近	离开
挨次	插队
插队	挨次,排队
唉叹	感叹
感叹	唉叹
哀痛	高兴,欢乐
哀求	逼迫,命令
命令	哀求,请求
哀乞	强求
强求	哀乞
哀哭	悲泣,欢笑
欢笑	哀哭
安然	危险
安宁	动乱,纷扰,恐怖,烦躁
安内	攘外
攘外	安内
安乐	忧患
忧患	安乐
安居	流浪
吵闹	安静
安步	快步
快步	散步,安步,慢步
碍眼	顺眼
碍口	脱口
脱口	碍口
爱慕	讨厌,嫌弃
嫌弃	亲近,爱慕
爱静	好动
好动	爱静,娴静
爱戴	轻慢
爱崇	鄙视
矮子	高个
高个	矮子
哀号	欢呼
欢呼	悲叹,哀号
庆贺	哀悼
哀辞	颂词,颂辞
颂词	哀辞
阿谀	谏诤
谏诤	阿谀
阿姨	叔叔
叔叔	阿姨
安逸	辛劳
辛劳	安逸
安心	不安,操心
安祥	烦躁
安详	焦灼,慌张,惊恐
安闲	忙碌
危急	安稳
安慰	打击
打击	扶助,拉拢,激发,安慰,勉励
按照	违背
按时	误期
误期	按时
按例	破例
破例	按例,常例
安装	拆卸
拆卸	镶嵌,安装
暗里	公然
暗箭	冷箭
冷箭	暗箭,明枪
暗晦	模糊
暗号	明码
暗沟	明沟
明沟	阴沟,阳沟,暗沟
暗处	明处
明处	暗处
暗藏	公开
暗昧	明朗
干净	肮脏,污秽
暗香	剧臭
剧臭	暗香
傲岸	谦逊
凹状	凸状
凸状	凹状
凹陷	突出,凸出,突兀
凸出	凹陷
凹下	凸起
凸起	隆起,凹下
凹凸	平滑
平滑	粗糙,凹凸
凹地	高地
高地	凹地,低地
凹版	凸版
凸版	凹版
昂首	俯首
俯首	昂首,低头
懊恼	庆幸
庆幸	懊恼
懊悔	无悔
无悔	懊悔,悔恨
奥妙	粗浅
傲骨	媚骨
媚骨	傲骨
遨游	静止
暧昧	明白
矮个子	高个子
高个子	矮个子
爱国者	卖国贼
卖国贼	爱国者
凹透镜	凸透镜
凸透镜	凹透镜
凹面镜	凸面镜
凸面镜	凹面镜
安分守纪	胡作非为
好高鹜远	安分守己
民康物阜	哀鸿遍野
安如盘石	累卵之危
累卵之危	安如盘石,安如磐石,磐石之固
祸在燃眉	安然无恙
安然无事	岌岌可危
安寝无忧	高枕无忧
不甘食贫	安贫乐道
爱财若命	挥金如土
蔼然可亲	凛然难犯
凛然难犯	蔼然可亲,金刚怒目
蔼譪春阳	蒙蒙细雨
蒙蒙细雨	蔼譪春阳
阿谀奉迎	刚正不阿
阿世阿俗	独往独来
独往独来	阿世阿俗
安於现状	奋发图强
安枕无忧	饱经忧患
饱经忧患	安枕无忧
无迹可寻	按图索骥,来龙去脉
暗无灯火	灯烛辉煌
灯烛辉煌	暗无灯火
暗室可欺	不愧屋漏
不愧屋漏	不欺暗室,暗室可欺
昂头挺立	摇尾乞怜,昂首挺立
摇尾乞怜	昂头挺立
昂首挺立	昂头挺立
傲世轻才	礼贤下士
傲骨嶙峋	卑躬屈节,卑恭屈节
卑恭屈节	傲骨嶙峋
播	收
瘪	鼓,饱
边	内
闭	开
弊	利
利	害,钝,弊
笨	灵
灵	笨
跋	序
序	跋
长官	部属
部下	下级
部门	全部
全部	部分,部门
步行	奔跑
奔跑	步行
步武	模仿
模仿	步武,创造
不振	低沉
不曾	曾经
曾经	不曾
不再	一再
一再	不再
不允	唯诺,允诺
唯诺	不允
不愿	愿意
愿意	不愿,反对,不肯
不要	必要
必要	不要
不雅	难看,雅观
难看	丢脸,不雅,好看
不许	准许
不休	甘休,开始
不幸	幸运
不实	虚假
不时	偶尔
不巧	正好,赶巧,凑巧
凑巧	不巧
不配	和谐
和谐	不配
足够	丰富,不足
不准	反对
不用	必须
必须	不用,不必,无须
不移	转变
转变	不移
不一	一一
一一	不一
不行	可行
可行	不行
不肖	忤逆
忤逆	不肖
不祥	吉利
吉利	不祥
不详	详尽
不惜	鄙弃
鄙弃	崇敬,不惜,珍藏,珍爱
不妥	失当
例外	不同
不停	停止
不爽	爽快
爽快	罗嗦,不爽
不如	落後
落後	不如,超越,赶上
不容	禁止
不确	偏差
偏差	不确,准确
不屈	反抗
不能	可以,能够
可以	不可,不能
不明	了然
了然	不明
不毛	富庶
不满	贪心,无餍,知足,满意
不论	辩论
辩论	不论
不利	有利
有利	妨害,无益,不利
不力	得力
得力	不力
不快	欢快
不肯	愿意
不计	礼让
礼让	争夺,不计
不料	意外,意料
意外	不料,故意
不可	可以
不苛	讲究
讲究	随便,粗陋,不苛
不均	平衡
平衡	不均
不决	决定
决定	不决
不倦	精神,疲倦
不拘	限制
不久	好久
好久	不久
不吉	祸兆,吉祥
祸兆	不吉
不及	超过,过之
超过	不及
不讳	忌讳
忌讳	不讳
不和	和睦
不合	非宜
非宜	不合
不光	仅仅
仅仅	统统,不光
不惯	习惯
习惯	不惯
不关	相关
相关	不关
不安	安心,操
捕鱼	放鱼
放鱼	捕鱼
哺育	摧残
补员	增员,裁员
增员	补员
补品	毒品
毒品	补品
补合	缝合,撕裂
缝合	补合
舶来	国产
国产	舶来,进口
勃兴	衰落
驳杂	混杂,复杂
驳回	受理
受理	驳回
驳斥	批准
批准	请示,驳斥
拨出	放入
放入	插进,拨出,拔出
病人	医生
医生	病人
并拢	闭合
闭合	张开,并拢
并立	独立,隶属
冰水	沸水
沸水	冰水
不顾	多虑
多虑	不顾
不苟	马虎,随便
不公	公允,偏见,偏袒
偏袒	不公,偏颇
不敢	胆敢
胆敢	不敢
不懂	陌生
不定	未必
未必	难免,一定,不定,必定
不第	落榜
不等	相等
相等	不等
不当	失当
不常	偶然
不便	麻烦
不必	无须,必须
补充	缩减,删减
删减	补充,增补
薄酌	小酌,盛宴
小酌	薄酌
薄幸	无情
薄莫	昧旦
昧旦	薄莫
薄礼	厚礼
厚礼	薄礼
薄待	优待,冷遇,苛待,优遇
薄酬	厚贶
厚贶	薄酬
搏斗	纷争,角斗
纷争	和解,协调,搏斗,平息
博学	末学,无知
博爱	偏爱
偏爱	博爱
剥离	黏贴,粘贴
粘贴	剥离
剥夺	享有,授与
享有	剥夺
波折	拂逆,顺遂
拂逆	波折
波谷	波峰
波峰	波谷
并处	同居
秉公	循私,徇私
徇私	秉公
摈除	招致
招致	摈除
不甘	甘心
甘心	不甘
不该	应该
应该	不该,可能
不服	信服
信服	不服
不妨	妨碍
妨碍	不妨,有关系
不凡	平凡
不法	违法
不对	正确
不断	中止
中止	不断
不端	端正,歪邪
歪邪	不端
表彰	批判,惩罚
表现	隐藏
表皮	内脏
内脏	表皮
表明	暗示
表面	本质,内里,面子,名义
变则	常则
常则	变则
变阴	转晴
转晴	变阴
瘪三	大亨
大亨	瘪三
别字	误字,错字
错字	正字,别字
别人	大伙,对方,自己
顺心	别扭
别名	笔名
笔名	别名
别离	重逢
重逢	离别,别离
别脚	简陋
憋闷	烦闷,舒畅
烦闷	憋闷,抑闷
表字	本名
表白	掩饰
标致	丑陋
标谤	称赞
标牓	毁谤
毁谤	称赞,标榜,赞美,赞扬,标牓
标榜	毁谤
变温	恒温
恒温	变温
变通	死板,明达,固执
死板	变通,灵活,生动
变例	通例,常规
常规	变例
变节	守节
便餐	酒宴
酒宴	便餐
扁舟	大船,小舟
小舟	扁舟
贬职	提拔,升官
升官	贬职
贬谪	升迁
升迁	贬谪
贬责	称许
称许	指责,贬责
贬抑	褒扬
贬义	褒义
褒义	贬义
贬词	褒词
褒词	贬词
边际	边缘
避暑	避寒
避寒	避暑
避匿	出头
出头	避匿
避开	参与
避居	藏隐
藏隐	避居
避忌	冲撞
冲撞	避忌
闭口	启齿
启齿	闭口
闭架	开架
开架	闭架
闭会	休会
闭馆	开馆
开馆	闭馆
毕生	半生
半生	毕生
鄙厌	属意
属意	鄙厌,移情,漠视
鄙俗	喧杂,高雅
珍藏	丢弃,鄙弃
鄙俚	高雅
曲折	笔直
变动	飘流,固定
便秘	腹泻
腹泻	便秘,泻肚
便函	公函
公函	私信,便函
便服	礼服,制服
制服	礼服,便服
鞭挞	爱抚
编新	述古
述古	编新
边区	外地
外地	边区,边境
边境	外地
蔽屣	废物,宝贝
碧绿	火红
火红	碧绿
弊害	利益
利益	害处,弊害
弊端	好处
敝眷	宝眷
宝眷	敝眷
敝号	小店
小店	敝号,宝号
敝国	贵国
贵国	敝国
敝地	贵地
贵地	敝地
敝处	贵处
贵处	敝处
庇护	揭发
揭发	袒护,包庇,庇护
闭着	闭上,睁开
闭上	闭着
闭庭	开庭
开庭	闭庭
闭幕	开幕
开幕	闭幕
必需	必定
必定	未必,恐怕,必需
必修	选修
选修	必修
恐怕	必定
敬慕	鄙夷
笔战	舌战
舌战	笔战
笔问	口答
口答	笔答,笔问
笔算	心算
心算	珠算,笔算
笔述	口述
口述	笔述
笔试	口试
口试	笔试
笔墨	口舌
口舌	笔墨
笔答	口答,口问
口问	笔答
逼真	失真
失真	逼真
逼迫	哀求
逼近	离开
本土	原土,客土
原土	本土
本体	本质
彼岸	此岸
此岸	彼岸
笨钝	愚拙
愚拙	聪慧,笨钝,智巧
笨蛋	聪明
本族	异族,同胞,同族
同族	本族
本职	兼职
兼职	专职本职,专职,本职
本则	附则
附则	本则
本嗓	假嗓
本钱	利钱
利钱	本钱
本末	始终
始终	本末
本地	外埠
外埠	本地
奔腾	静止
奔逃	顽抗
顽抗	慑服,输诚,奔逃
奔丧	报喜
奔放	拘谨,伶巧
被迫	他动,被动,自动
被掳	逮捕
逮捕	被掳,释放
被荐	他荐
他荐	被荐
被害	加害
加害	被害
背约	履约
履约	毁约,背约,失约
背信	失信
背时	走运
北国	南国
南国	北国
北风	南风
南风	北风
北方	南方,炎方,朔方
朔方	北方
北部	南部
南部	北部
北边	南边
南边	北边
碑阴	碑面
碑面	碑阴
悲忧	愉快
卑末	高尚
卑陋	华贵
华贵	卑陋
卑劣	高贵,高尚
卑见	谬论,愚见
卑辈	後辈,长辈
後辈	卑辈
报复	报答
报答	报复
报仇	感恩,报恩
保养	损伤
损伤	保养,保护
保险	危险,风险
背面	正面
背静	喧闹,热闹
背光	向光
向光	背光
背地	当面
北纬	南纬
南纬	北纬
北上	南下
南下	北上
北面	南面
南面	北面
北门	南门
南门	北门
北极	南极
南极	北极
北货	南货
南货	北货
悲痛	开心
悲叹	欢呼
悲泣	哀哭
悲戚	高兴
悲凄	悲伤
悲凉	欢乐
悲苦	乐趣,欢乐
悲歌	笑语
笑语	悲歌
悲怆	颓唐
颓唐	悲怆
纯洁	卑污,贞洁,肮脏,淫荡
卑俗	粗俗,高雅
卑人	贵人
贵人	卑人
爆发	消弭,发动
发动	爆发
暴涨	暴跌,猛跌
暴跌	腾踊,暴落,暴涨
暴食	节食
节食	暴食
暴怒	隐忍
隐忍	暴怒
暴落	暴跌
攻击	保卫,抗御,防守
保全	牺牲,粉碎,歼灭
歼灭	保全
饱学	浅学
浅学	饱学
宝号	大号,小号,小店
大号	宝号
宝贵	低贱
宝贝	垃圾,蔽屣
宝爱	醉心,喜好
喜好	宝爱,厌恶
褒奖	处分
处分	奖励,褒奖
褒嘉	儆戒
儆戒	褒嘉
包羞	受辱
受辱	雪耻,包羞
帮手	仆从
仆从	帮手
帮忙	捣乱
帮办	主办
主办	帮办
邦交	缔交
缔交	邦交
饱暖	温饱,饥寒
温饱	饱暖
奋发	消沉,饱满,苟安
饱餐	绝食
绝食	饱餐
宝重	轻贱
宝马	良马,名驹
名驹	宝马
包含	除外
除外	包含
包藏	揭露,罗列,袒露
傍晚	薄暮,黎明,凌晨
绑架	擒获
擒获	逃脱,绑架
帮助	干扰,欺负
干扰	帮助,辅助,协助
半路	一路
一路	半路
搬家	定居
斑斓	黯淡
黯淡	斑斓
败阵	胜仗
败兆	胜兆
胜兆	败兆
败兴	高兴
败落	萧条
败露	隐藏
败类	圣贤,模范
模范	败类
败局	胜局
胜局	败局
败坏	维护
白人	黑人
黑人	白人
白热	赤热
赤热	白热
白契	红契
红契	白契
白米	糙米
糙米	白米
白脸	黑脸
黑脸	白脸
白军	红军
红军	白军
白净	黑黝
黑黝	白净
跋语	序言
板滞	灵活
板结	松软
稗史	正史
正史	野史,稗史
拜领	领受
拜访	光临
光临	拜访
摆阔	哭穷
白发	衰颜,朱颜,鹤发
鹤发	白发
白丁	鸿儒
鸿儒	白丁
白痴	天才
白案	红案
红案	白案
霸者	王者
王者	霸者
霸道	王道
王道	霸道
罢职	复职
罢休	继续,开端
罢手	停工
停工	罢手
罢免	解雇,任用,罢黜,录用
罢工	复工
复工	罢工
罢黜	罢免
把守	弃守
弃守	把守
拔出	放入
暴戾	温顺
暴力	和平
腾踊	暴跌
抱怨	谅解,感谢
谅解	怪罪,抱怨,埋怨
报丧	贺喜
裨益	保护
布纹纸	光面相片
光面相片	布纹纸
不雅观	雅观
雅观	不雅,不雅观
不值得	值得
值得	不值,不值得,不屑
不结实	牢固
不高兴	高兴
不安分	守分
守分	安分,不安分
薄湿湿	暖烘烘
暖烘烘	冷丝丝,凉丝丝,薄湿湿
舶来品	本地货,洋货
剥削者	劳动者
劳动者	剥削者
不伏手	伏手
伏手	顺手,不伏手
贬义词	褒义词
褒义词	贬义词
闭卷考	开卷考
开卷考	闭卷考
闭幕式	开幕式
开幕式	闭幕式
必需品	奢侈品
奢侈品	必需品
必修科	选修科
选修科	必修科
必然性	偶然性
偶然性	必然性
本国货	来路货
来路货	本国货
本地货	舶来品
被害人	加害人
加害人	被害人
北寒带	南寒带
南寒带	北寒带
北方人	南方人
南方人	北方人
北半球	南半球
南半球	北半球
背光性	向光性
向光性	背光性
背风坡	迎风坡
迎风坡	背风坡
背风面	迎风面
迎风面	背风面
北温带	南温带
南温带	北温带
北极圈	南极圈
南极圈	北极圈
北极光	南极光
南极光	北极光
傍亮儿	傍黑儿
傍黑儿	傍亮儿
白茫茫	白花花,黑压压,黑黢黢,明晃晃,白晃晃
黑压压	白茫茫
白脸儿	黑脸儿
黑脸儿	白脸儿
白晃晃	白茫茫
白花花	白茫茫
百链钢	绕指柔
绕指柔	百链钢
暴发户	破落户
破落户	暴发户,沦落户
扬扬无备	步步为营
布衣小民	卑官下吏
卑官下吏	布衣小民
布衣蔬食	粗衣恶食
粗衣恶食	布衣蔬食
步人後尘	标新立异
步履维艰	大步流星
大步流星	步履维艰
步履如飞	蜗步难移
蜗步难移	步履如飞
步履艰难	健步如飞
健步如飞	步履艰难
布面相片	反光相片
反光相片	布面相片
不知凡几	如数家珍
不折不扣	七折八扣
七折八扣	不折不扣
不言不语	绘影绘声
绘影绘声	不言不语
不虚此行	徒劳往返
徒劳往返	不虚此行
不修边幅	衣冠楚楚
不事张扬	大事铺张
大事铺张	不事张扬
不识时务	审时度势
不识大体	顾全大局
顾全大局	不识大体,各自为政
不声不响	大喊大叫
大喊大叫	不声不响
不乾不净	一乾二净
一乾二净	不乾不净
畸轻畸重	不偏不倚
悖理违情	不近人情,蛮横无理
不见天日	重见天日
不见经传	引经据典,胡说八道
不露声色	勃然变色,义形於色
义形於色	不露声色
不露身手	不显身手,显露头角
不显身手	不露身手
不亢不卑	低三下四,趾高气扬,高人一等
摩顶放踵	好逸恶劳,不辞辛劳
出乎意料	不出所料
捕蛇去齿	为虎傅翼
为虎傅翼	为民除害,捕蛇去齿
勃然变色	不露声色
霄壤之别	伯仲之间
伯歌季舞	相煎何急
并肩前进	背道而驰
相去万里	并驾齐驱
兵多将广	兵强马壮,兵强将勇,兵少将微
兵出无名	师出有名
道貌岸然	不苟言笑
不苟言谈	高谈阔论
不甘落後	标新立异
不惮其烦	不胜其烦
不胜其烦	不惮其烦
不差累黍	短斤缺两
短斤缺两	不差累黍
不败之地	百战不殆
薄幸堪惊	情深似海
薄海同仇	普天共友
普天共友	薄海同仇
博闻见广	孤陋寡闻
博施众济	善财难舍
善财难舍	博施济众,博施众济
博施济众	善财难舍
波涛汹涌	风平浪静,大风大浪
波澜起伏	生花妙笔,抑扬顿挫
并存不悖	势不两立
兵微将寡	兵强马壮,军多将广
军多将广	兵微将寡
兵少将微	兵多将广
兵强将勇	兵多将广
宾客填门	门可罗雀
宾客如云	门可罗雀
不甘後人	甘居中游
甘居中游	不甘後人
不甘雌服	不甘示弱
不甘雌伏	甘拜下风
不分畛域	一视同仁
不分皁白	是非分明
不分轩轾	权衡轻重
权衡轻重	不分轩轾
别有用心	偷偷摸摸,襟怀坦白
别无长物	尽付阙如
尽付阙如	别无长物
别具只眼	平平无奇
平平无奇	别具只眼
别具匠心	如法炮制
别创新格	墨守成规
别出新裁	如法泡制,依样葫芦
如法泡制	别出新裁
依样葫芦	别出心裁,别出新裁
别辟蹊径	如出一辙,墨守成法
标奇立异	陈陈相因,勇猛精进,故步自封
变幻无常	一成不变
必有一得	愚者千虑
愚者千虑	必有一得,智者千虑，必有一失
变化莫测	见机行事,一成不变
变化多端	面目一新,一成不变
敝屣视之	垂涎三尺
闭月羞花	貌似无盐
貌似无盐	闭月羞花,沉鱼落雁
闭门不纳	倒屣相迎
倒屣相迎	闭门不纳
鼻鼾如雷	目不交睫
目不交睫	鼻鼾如雷
本性难移	江山易改
江山易改	本性难移
比众不同	一丘之貉
比屋可封	比屋而诛,比屋而封,良莠淆杂
良莠淆杂	比屋可封
比屋而诛	比屋可封
比屋而封	比屋可封
笨嘴拙腮	能说会道
奔波劳碌	优游自在
背若芒刺	心怀舒畅
心怀舒畅	背若芒刺
北回归线	南回归线
南回归线	北回归线
卑躬屈节	傲骨嶙峋
卑辞厚礼	出言不逊
备尝艰苦	一帆风顺
贝积如山	囊空如洗
囊空如洗	腰缠万贯,贝积如山
从	主
次	主
穿	脱
脱	穿
初	末
臭	香
香	臭
赤	黑
耻	荣
陈	新
潮	干
撤	设
设	撤
昌	亡
侧	正
残	全
操	不安
挫折	顺利,成功
撮弄	挑拨
撮合	拆散,离间
正字	俗字,错字
错杂	整齐
存款	提款
提款	支款,存款
促成	抑制
粗制	精制,滥造
精制	粗制
粗硬	细软
细软	粗硬
粗野	客套,文明
粗实	单薄
粗识	略懂
略懂	粗识,精通
粗拉	细致
粗贱	名贵
名贵	粗贱
粗活	细活
细活	粗活
粗忽	精细
粗工	巧匠
巧匠	粗工
粗布	细布
细布	粗布,毛布
翠绿	枯黄
枯黄	青翠,翠绿
摧折	护持
护持	摧折
促声	舒声
舒声	促声
粗纱	细纱
细纱	粗纱
粗人	雅士
雅士	粗人
粗品	精品
精品	粗品
粗率	精致
粗陋	精美,讲究
粗粮	细粮
细粮	粗粮
聪灵	痴獃
痴獃	聪灵
匆促	从容
从因	主因
主因	从因
从刑	主刑
主刑	从刑
此刻	从前
雌性	雄性
雄性	雌性
雌伏	雄飞
刺耳	顺耳,动听
次席	末席
末席	次席
辞任	离职
离职	离任,在职,辞任
辞别	相逢
相逢	告辞,辞别,分离,分别,分袂
慈心	狠心
狠心	慈心
纯种	杂种
杂种	纯种
纯正	搀杂
搀杂	纯正
纯真	世故
世故	纯真,天真
纯血	混血
混血	纯血
纯损	纯利
纯利	纯损,毛利
纯色	杂色
杂色	纯色
纯良	顽劣
顽劣	纯良,驯良
纯厚	阴险
垂线	斜线
斜线	垂线
创立	推翻
传统	现代
传奇	史实,事实
触觉	听觉
听觉	触觉,视觉
触礁	离礁
离礁	触礁
处治	惩罚
蠢动	雄飞
蠢才	捷才
捷才	天才,蠢才
春天	秋天
秋天	春天
春风	秋雨
秋雨	春风
春初	腊尾
腊尾	春初
垂直	倾斜,水平
传经	送宝
送宝	传经
储蓄	消费
消费	储蓄,供应,生产,积存,积累
初期	末期
末期	初期
初年	末年
末年	初年
初婚	再婚
再婚	初婚
初会	再会
再会	初会
初犯	累犯
累犯	初犯,再犯,屡犯
初等	低等
低等	上等,劣等,高等,下等,初等
出航	返航
出海	靠岸
靠岸	出海
出工	缺,旷工,收工
缺	出工,满,旷工,剩,余
旷工	出工,缺
出典	赎取
赎取	出典
出城	进城
进城	出城
出场	退场,进场
筹码	现款
现款	筹码
稠浊	简明
愁然	戚然
戚然	愁然,恻然,欣然
愁闷	快活
储积	消耗
出帐	进帐
进帐	出帐
出院	入院
入院	出院
出狱	入狱
入狱	坐牢,出狱
出血	止血
止血	出血
出山	蛰居
蛰居	出山
出色	平淡,增色,平凡
出让	推卸
出去	进来,入来
进来	出去,进入
出勤	缺勤
缺勤	出勤
出列	入列
入列	出列
出来	进去
进去	出来
出库	入库
入库	出库
充满	空虚
出诉	受诉
受诉	出诉
丑极	艳绝
艳绝	丑极
丑妇	美人
美人	丑妇,丽人
丑恶	艳丽,美好,善良
筹商	独断
独断	商议,筹商
赤诚	奸诈,虚伪
斥逐	摈弃
嘲笑	同情,称颂,赞美
赞美	毁谤,指摘,讥刺,唾骂,嘲笑,责怪
嘲弄	赞扬
赞扬	毁谤,耻笑,责难,嘲弄,指责
嘲讽	称赞,赞赏
赞赏	非难,嘲讽
惩办	奖励
乘坐	驾驶
驾驶	乘坐
乘客	司机
司机	乘客
乘便	顺便
城区	郊区
城内	野外,市区
市区	郊外,城内
承平	纷乱
承诺	拒绝
承当	推卸
呈现	消失
成立	撤消,撤废,解散
称道	讥评
讥评	谴责,称道
衬衣	外套
外套	衬衣
晨雾	夜雾
夜雾	晨雾
晨光	夕照,夕阳
晨风	晚风
晚风	晨风
陈年	当年
当年	陈年,今日
沉睡	觉醒,苏醒
沉实	端庄
端庄	沉实
沉溺	自拔
自拔	沉溺
沉默	发言,喧闹,做声
发言	说话,作声,讲话,沉默
沉迷	觉悟
觉悟	醒悟,省悟,醒觉,沉迷,执迷
沉沦	奋起
奋起	沉沦
沉疴	小恙
小恙	沉疴
澈底	马虎
设立	拆除,撤销
撤消	成立
撤离	进驻,占领
进驻	撤离
撤军	进军
进军	撤军
撤回	提出,派遣
撤废	成立
朝霞	晚霞
朝日	旭日
夕照	朝晖,晨曦,晨光
朝晨	晨曦,夕暮
成仇	交恶
交恶	和好,成仇
成长	枯萎
成本	利润
利润	成本
撑腰	拆台
称职	渎职
渎职	称职
撤兵	出兵
出兵	撤兵
创新	抄袭
倡导	阻止
阻止	倡导,提倡,唆使
畅快	忧郁,郁闷
郁闷	畅快,舒畅
常服	礼服
礼服	制服,常服,便服
长针	短针
短针	长针
超卓	平凡
超支	结余
超越	落後
超人	凡夫
凡夫	圣人,名人,庸人,超人
超出	少于
少于	超出
常事	奇事
奇事	常事
常人	奇人
奇人	常人
常量	变量
常例	破例
常久	临时
常见	稀奇,罕见,稀有
罕见	常见,习见
长大	短小
短小	长大
长打	短打
短打	长打
长存	磨灭
磨灭	不朽,长存
长辈	卑辈,小辈
猖獗	收敛
昌隆	衰败
颤栗	镇定
拆开	连结,组合
组合	拆开,分解
拆夥	合夥,分夥
合夥	拆夥
拆股	合股
合股	散夥,拆股
修复	拆除
拆版	拼版
拼版	拆版
差异	相同
差遣	召回
差劲	低劣
长篇	短篇
短篇	长篇
长跑	短跑
短跑	长跑
长命	长寿
长裤	短裤
短裤	长裤
长进	退步
退步	进步,长进
长工	散工
散工	长工
颤动	平静
阐扬	遮没
遮没	阐扬
产生	消灭,消失,消亡
缠住	摆脱
差错	正确
诧异	镇定
岔道	邪道
邪道	岔道
草质	木质
木质	草质
草民	权臣
权臣	草民
惨败	大胜,劣败
大胜	惨败
惨白	红润
惭愧	自满
自满	虚心,谦虚,惭愧
残照	朝晖
残障	健全
残阳	朝阳,余晖
彩色	黑白
黑白	彩色
采用	放弃
采纳	放弃
裁种	收成
收成	裁种,栽种
裁员	补员
插入	删去
删去	插入
插进	放入
侧卧	伏卧
伏卧	仰卧,横卧,侧卧
侧目	回避
回避	探望,侧目,正视
草率	郑重,认真
草稿	定稿
定稿	草稿
苍老	年青,矍铄
年青	古老,苍老
黑瘦	苍白,红润
仓猝	从容
惨重	轻微
惨事	快事
快事	惨剧,惨事
惨切	欢乐
惨剧	快事
惨澹	灿烂
残品	正品
残虐	抚慰
抚慰	残虐
残酷	仁慈,慈祥
残旧	簇新
残废	健全
残冬	新春
新春	残冬
残暴	仁慈
财神	穷鬼
穷鬼	财神
猜疑	信赖,相信
信赖	警戒,猜疑
猜想	确定
确定	估计,猜想,似乎,猜测,仿佛
猜忌	怀疑
谗间	说合,中伤
中伤	谗间
搀合	分解
操切	从容
藏拙	献丑
献丑	藏拙
藏身	露面
露面	明示,藏身
藏锋	露锋
露锋	藏锋
参军	复员
复员	参军,入伍
参差	整齐
猜测	确定
徵召	召集
徵税	纳税
徵借	摊还,没收
没收	徵借
徵集	遣散
徵兵	募兵
募兵	徵兵
矬子	僬侥
僬侥	细人,侏儒,矬子
舛讹	正确
舛错	正确
惆怅	舒畅,得意
憧憬	失望
叱责	表扬
潺湲	湍急
湍急	潺湲
恻然	戚然
清静	嘈杂,烦扰
寸草心	三春晖
三春晖	寸草心
出柙虎	笼中鸟
笼中鸟	出柙虎
迟暮之年	二八年华
二八年华	迟暮之年
驰名远近	湮没无闻
湮没无闻	驰名远近
崇功报德	兔死狗烹
赤绳系足	好梦难成
好梦难成	赤绳系足
耻与为伍	明哲保身
齿豁头童	返老还童
尺布斗粟	手足情深
手足情深	尺布斗粟
偏激之词	持平之论
迟疑不决	应机立断
应机立断	迟疑不决
逞意妄为	刻意自约
刻意自约	逞意妄为
程门立雪	班门弄斧
班门弄斧	程门立雪
城府深密	沥胆披肝
沥胆披肝	肝胆相照,假仁假义,城府深密
成事在天	天意难违
天意难违	成事在天
成事在人	听天由命
成仁成义	视死如归
称心满意	事与愿违
陈规陋习	清规戒律
沉鱼落雁	貌似无盐
惰	勤
冻	化
丢	拾
点	面
递	接
接	扔,交,递
当	赎
赎	押,当
立	破,倒
喋	呐呐
呐呐	喋
多嘴	寡言
寡言	多嘴
多助	联力
联力	多助
多欲	寡欲
寡欲	多欲
多心	分心
分心	异志,入神,多心,一心,专心,凝神,静心
多闻	寡闻
寡闻	多闻
顿悟	渐悟
渐悟	顿悟
钝涩	滞钝
滞钝	钝涩
钝器	利器
利器	钝器
躲藏	暴露
多礼	失仪,得体
得体	多礼,失礼
多见	习见
习见	多见,罕见
多福	多难
多难	多福
多才	无能
无能	多才,庸才
钝根	天赋
天赋	钝根
囤积	抛售
敦实	瘦小
兑现	许愿
对酌	独酌
独酌	对酌
对方	别人
对抗	分裂
对话	独白,独语
独白	对话
断续	一直,间断
断水	给水,供水
给水	断水
短少	多余
多余	短少
短期	瞬间
瞬间	长期,短期
短见	远瞩
远瞩	短见,卓见
短程	短途
堵住	通过
独奏	合奏
合奏	独奏
独资	醵资,散股
醵资	独资
独峙	鼎立
鼎立	独峙
独语	对话
独特	共同,一般
独宿	共枕,共衾
共衾	独宿
冻结	消融,流通,流动
消融	冻结
懂行	外行
冬衣	夏衣
夏衣	冬衣
冬天	夏天
夏天	冬天
冬季	夏季
夏季	冬季
东洋	西洋
西洋	东洋
东首	西首
西首	东首
定论	异论
异论	定论,同论
订约	解约
顶风	逆风,顺风
逆风	顶风
顶端	基础,尖端
尖端	基础,顶端
端严	落拓
落拓	端严,呆钝,得志
端淑	贤慧
贤慧	端淑,泼辣
独捐	摊认
摊认	独捐
独唱	齐唱
齐唱	独唱
独霸	分享
分享	独霸,瓜分
陡立	平坦
陡峻	平坦
斗智	斗力
斗力	斗智
斗武	斗文
斗文	斗武
动物	静物
静物	动物
动土	竣工,落成
动听	难听,刺耳
动态	静态
静态	动态
动脉	静脉
静脉	动脉
动笔	搁笔
搁笔	动笔
东南	西北
西北	东南
东面	西面
西面	东面
东门	西门
西门	东门
东郊	西郊
西郊	东郊
东端	西端
西端	东端
东侧	西侧
西侧	东侧
东部	西部
西部	东部
东北	西南
西南	东北
东岸	西岸
西岸	东岸
定约	联盟
联盟	定约
定说	异说,通说
通说	定说
斗殴	打仗
打仗	斗殴
调低	提高
吊宴	贺宴
贺宴	吊宴
吊书	贺书
贺书	吊书
吊扇	台扇
台扇	吊扇,立扇
点亮	熄灭
递送	接收
地核	地表
抵御	保卫,屈服
抵赖	承认,认帐
抵拒	服从
服从	抵拒,违背,违抗,抗拒
抵髑	相符
相符	抵髑
抵挡	进攻
敌军	友军
友军	敌军
友邦	我国,敌国
高唱	低吟
低音	高音
高音	低音
低压	高压
高压	低压
低下	卑下
低温	高温
高温	低温
低洼	平坦
低速	高速
高速	低速
调唆	挑拨
调皮	老实,听话
调回	派遣
调高	降低
吊词	贺词
凋射	盛开
凋敝	繁荣
刁民	良士
良士	刁民
刁悍	仁慈
刁恶	狠毒
狠毒	慈祥,刁恶
惦念	忘记
佃农	地主
地主	佃农
典型	普通,一般
废约	缔约
低声	柔声,高声
柔声	低声
低平	低垂,高耸
低品	下品,劣品,上品
劣品	低品,上品
低能	低劣
低空	高空
高空	低空
低估	高估
高估	低估
低额	高额
高额	低额
低度	高度
高度	低度
高调	低调
低地	高地
低低	高高
高高	低低
劣等	优等,低等
低档	高档
高档	低档
低处	高处
高处	低处
低潮	高潮
高潮	低潮
低唱	放歌
放歌	低唱
低矮	高耸
等闲	平凡
等外	合格
合格	等外
登台	下台
下台	上台,登台
的论	高见
德政	暴政
德育	体育,智育
智育	德育
德化	威服
威服	德化
得宜	得当
得当	失当,得宜
失礼	礼貌,得体
得时	失时
得利	顺利
顺利	挫折,周折,荆棘,得利
到任	免职
离去	归来,到达
挡路	让路
让路	挡路
挡驾	驱逐
驱逐	挡驾
当国	失权
失权	当国
淡雅	浓艳
得计	失策
失策	得计
得回	获得
得宠	失宠
失宠	得宠
道歉	责怪
道别	相见
相见	道别
捣毁	废除
倒霉	利市,幸运,厄运
倒立	横卧,平放,直立
横卧	伏卧,倒立
当日	他日
他日	当日
淡墨	浓墨
浓墨	淡墨
淡抹	浓妆
浓妆	淡抹,浓抹
淡淡	浓浓
浓浓	淡淡
弹性	塑性
塑性	弹性
弹丸	广漠
广漠	弹丸
弹刻	惩处
弹劾	贬斥
耽搁	提前
担承	卸责
卸责	担承
单衣	夹衣
夹衣	单衣
单一	总合,繁杂,复杂
单线	复线
复线	单线
单打	双打
双打	单打
单称	复称
复称	单称
贷方	借方
借方	贷方
怠懈	勤奋
勤奋	怠懈
诞妄	荒谬
荒谬	诞妄
胆壮	心虚
心虚	胆壮
胆寒	勇敢
歹心	歹意
歹意	好心,歹心,善心
歹人	好人
歹毒	慈善
呆钝	落拓
呆笨	聪明
机灵	呆板,迟钝,拙笨,伶利
大着	拙作,大作
大作	大着
大灶	小灶
小灶	大灶
大月	小月
小月	大月
大约	精确
大笑	窃笑
窃笑	大笑
大慰	狂喜
狂喜	大慰
大体	详细
大陆	陆地
陆地	大陆
单数	双数,复数
双数	单数
单式	复式
复式	单式
单利	复利
复利	单利
单句	复句
复句	单句
单轨	双轨
双轨	单轨
单杠	双杠
双杠	单杠
怠缓	缓慢
怠工	加班
加班	怠工
带怨	含情
含情	带怨
代理	署理
署理	代理
大雨	细雨
细雨	大雨
大宴	盛宴
盛宴	薄酌,大宴
大雪	小雪
小雪	大雪
大写	小写
小写	大写
大人	孩子
孩子	大人
大盘	小盘
小盘	大盘
大节	小节
小节	大节
大家	个人
大夥	大众
大众	大夥
大伙	别人
大话	实话
大河	小溪
小溪	大河
大船	扁舟
大乘	小乘
小乘	大乘
打怵	局促
打扮	卸装
打败	战败
天空	大地
大抵	具体
大道	小径,正途
正途	歧途,大道
打头	垫后
垫后	打头
打扰	配合
配合	刁难,反对,打扰
答问	解答
解答	答问,答覆
答理	拒绝
答覆	解答
答词	训词
训词	答词
答辩	寻问
寻问	答辩
渎神	敬神
敬神	渎神
巅峰	低谷
低谷	巅峰
诋譭	贬斥
籴入	粜出
粜出	籴入
多幕剧	独幕剧
独幕剧	多幕剧
对得起	对不起
对不起	对得起
独木桥	阳关道
阳关道	独木桥
独立国	附庸国
附庸国	殖民地,独立国
东半球	西半球
西半球	东半球
低血压	高血压
高血压	低血压
低气压	高气压
高气压	低气压
低能儿	高材生
高材生	低能儿
淡水鱼	咸水鱼
咸水鱼	淡水鱼
淡水湖	咸水湖
咸水湖	淡水湖
大杂烩	清一色
清一色	大杂烩
大老婆	小老婆
小老婆	大老婆
单记法	连记法
连记法	单记法
遁世无闻	家喻户晓
家喻户晓	遁世无闻
遁世逃名	毛遂自荐
毛遂自荐	遁世逃名
多口相声	单口相声
单口相声	多口相声
度德量力	不自量力
杜门株守	远走高飞
远走高飞	杜门株守
杜绝後患	除恶务尽,杜渐防微
杜渐防微	杜绝後患
低头哈腰	顶天立地
时光冉冉	度日如年
独立思考	随声附和
有眼无珠	独具只眼
独到之见	尽去陈言
尽去陈言	独到之见
独垂青盼	白眼频加
白眼频加	独垂青盼
独持异议	各持己见
各持己见	舍己从人,独持异议
斗志昂扬	心灰意懒,委靡不振
斗筲之器	褊狭小器
褊狭小器	斗筲之器
动摇不定	坚韧不拔
丢盔弃甲	一战即溃
一战即溃	丢盔弃甲,旗开得胜
吊民伐罪	犯上作乱
犯上作乱	吊民伐罪
抵瑕蹈隙	讳过称善
讳过称善	抵瑕蹈隙
流金铄石	滴水成冰
低头不语	振臂高呼
振臂高呼	低头不语
颠倒而行	顺序而进
顺序而进	颠倒而行
地望高华	声名狼藉
得其所哉	失魂落魄
蹈袭故常	披荆斩棘
淡妆素服	翠绕珠围
翠绕珠围	淡妆素服
淡於名利	热中利禄
热中利禄	淡於名利
合浦还珠	得而复失
道听涂说	亲见其事
亲见其事	道听涂说
道近易从	曲高和寡
当时得令	明日黄花
明日黄花	当时得令
当局者迷	旁观者清
旁观者清	当局者迷
淡饭清茶	山珍海错
大展宏图	一筹莫展
大相迳庭	并行不悖
大题小做	小题大做
单记投票	连记投票
连记投票	单记投票
单调平凡	丰富多彩
丰富多彩	单调平凡
大事招摇	四处招摇,销声匿迹
四处招摇	大事招摇
喁喁细语	大声疾呼
大权在握	大权独揽
大权独揽	大权旁落,大权在握
大权旁落	大权独揽
大才盘盘	博学多才
大饱私囊	涓涓归公,涓滴归公
涓滴归公	大饱私囊
大风大浪	波涛汹涌
答答含羞	落落大方
屈己从人	咄咄逼人
独树不成林	聚沙成塔
聚沙成塔	独树不成林
恶性	良性
良性	恶性
恶习	良习,美德
美德	恶习
恶徒	善人
善人	恶徒
恶评	好评
好评	恶评
恶梦	吉梦,好梦
好梦	恶梦
耳生	耳熟
耳熟	耳生
恩人	仇人
恩爱	仇恨
恶计	良谋
良谋	恶计
恶汉	懦夫
清香	恶臭
恶报	好报
好报	恶报,善报
扼杀	扶植
额外	份内,分内
份内	额外
耳闻	目击,目睹
目睹	耳闻
愕然	坦然
坦然	愕然
恶运当头	红鸾照命
红鸾照命	恶运当头
英雄气短	儿女情长
恩同再造	切齿之仇
切齿之仇	恩同再造
恶毒心肠	慈悲心肠
慈悲心肠	恶毒心肠
二三其德	见异思迁
腹	背
复	单
负	胜
付	收
仰	俯
抚	剿
剿	抚
封	开
返	往
防	攻
伐	植,栽
富态	干瘦
富人	富豪
富豪	富人,贫士
富强	贫弱
贫弱	富强
富矿	贫矿
贫矿	富矿
入伍	复员,退役
复兴	衰落,论亡
复苏	萧条
复数	单数
复赛	决赛
掀开	覆盖
泻肚	腹泻
缚束	解放
解放	束缚,缚束
赋予	接受,索取,授予
赋闲	余暇,繁忙
赋别	欢聚
贫贱	富贵
副业	专业
专业	副业,业余
副线	支线,主线
支线	副线
副品	废品
废品	正品,副品
副本	复本
复本	正本,副本
复旧	革新
复婚	离婚
离婚	仳离,复婚
复合	简单
负号	正号
正号	负号
低头	抬头,俯首
仰视	俯视
俯瞰	仰望,俯看
俯看	仰望,俯瞰
浮松	软熟
软熟	浮松
浮夸	朴实
朴实	华丽,浮夸
浮华	华美,纯朴
华美	浮华
浮泛	切实,透澈
切实	虚浮,浮泛
推倒	扶起
扶持	凌逼,压抑
伏暑	严冬
严冬	盛暑,伏暑,炎暑,酷暑
附带	专门
负责	搪塞,敷衍,唐塞
搪塞	负责
负气	骄恣
骄恣	负气,谦抑
负面	正面
负极	正极
正极	负极
新生	腐朽,垂死
腐儒	名宿
名宿	腐儒
腐烂	鲜美,新鲜
腐化	进取
进取	腐化,退守
腐恶	鲜美
鲜美	腐烂,腐恶
辅助	干扰,次要
抚养	赡养
赡养	抚养
福相	穷相
穷相	福相
福气	晦气
晦气	福气
浮艳	淳朴
淳朴	浮艳
浮现	消失,淹没
服帖	服理
服理	服帖
敷裕	宽裕
敷衍	竭力,认真,负责
肤泛	深刻
否决	通过
否定	肯定,判定
肯定	否定
封斋	开斋
开斋	封斋
封口	吐口
吐口	封口
扶助	打击
扶直	推翻
奉承	讽刺,恭维,奚落
奚落	奉承
讽谏	直谏
直谏	讽谏
讽刺	恭维,奉承
恭维	讽刺,挖苦,奉承
讽词	谀词
谀词	讽词
风险	保险
风起	风静
风静	风起
丰产	歉收
分袂	相逢
分论	总论
总论	分论
分流	合流
合流	分流,干流
分夥	拆夥
费时	省时
省时	费时
费难	省事
肥壮	羸弱
羸弱	肥壮,强壮,健硕
丰足	贫乏
丰腴	苗条
苗条	丰腴,肥胖
丰盈	干瘦
丰润	憔悴
憔悴	丰润
丰饶	贫乏,贫瘠
歉岁	丰年
愤恨	喜爱
奋勇	恇怯
恇怯	奋勇
奋勉	懈怠
懈怠	奋勉,发奋
消沉	奋发,振奋,激昂
粉碎	保全
粉饰	揭露
分头	合并
集中	民主,分散
分权	集权,均权
均权	分权
分歧	一致,默契,纷歧
一致	分歧
分明	隐约,模糊
分发	应募,募集
应募	分发
分担	总揽
总揽	分担
非攻	厌战
厌战	非攻,好战
非常	平常
飞腾	坠落
坠落	飞腾
飞昇	溅落
溅落	飞昇
纷歧	分歧
严整	纷乱,严密
纷繁	单纯
单纯	纷繁,复杂,繁复
总结	分析
分文	万贯
万贯	分文
放慢	加快,减速,减慢
减慢	加快,放慢
放宽	收紧,紧缩
收紧	放宽
放电	充电
充电	放电
放大	缩小
仿佛	确定
出发	返回,到达
反义	同义
同义	反义
反诉	原诉
原诉	反诉
飞驰	缓慢
放下	拿起
拿起	放下
放送	收听
收听	放送
防战	攻战
攻战	防战
防范	疏忽
方形	圆形
圆形	方形
泛起	消失
犯罪	立功,犯过
犯过	犯罪,立功
犯疑	相信
返乡	离家
离家	返乡
反射	曲射,直射,折射
曲射	反射
反派	正派,邪派
邪派	反派
凡愚	圣贤
圣贤	凡愚,败类
凡眼	慧眼
慧眼	凡眼
凡童	神童
神童	凡童
凡俗	高超
凡是	特殊
凡品	奇珍
奇珍	凡品
凡才	逸才
逸才	凡才
法界	天界,俗界
天界	法界
发泄	郁积
郁积	发泄
发射	回收
回收	发射
发烧	退烧
退烧	发烧
发妻	簉室,正室
正室	偏房,发妻
发胖	肥胖
反覆	专一
专一	反覆,纯粹
反复	偶尔
反常	变态
烦冗	简单
烦扰	清静
烦愁	痛快
凡作	杰作
杰作	凡作
凡知	睿知
睿知	凡知
发胀	丰满
发展	衰落,衰退
发亮	发暗
发暗	发亮
发货	收货
收货	发货
发还	释放
发疯	理智
理智	感情,发疯,狂热
发奋	懈怠
发放	领取
发端	终止
终止	发端,开始,进行
发愁	高兴
发病	痊癒
痊癒	发病
反比	正比
正比	反比
繁重	轻松
繁琐	简便
繁冗	罗唆
繁复	单纯,复杂
绯红	煞白
煞白	通红,绯红
富家儿	窭人子
窭人子	富家儿
殖民地	附庸国
非卖品	出售品
出售品	非卖品
非法性	合法性
合法性	非法性
反射线	入射线
入射线	反射线
反射角	投射角
投射角	反射角
法律审	事实审
事实审	法律审
反对者	同盟者
同盟者	反对者
反比例	正比例
正比例	反比例
寒微简陋	富丽堂皇
富甲一方	家徒四壁
覆辙重蹈	前车可鉴
鸾飘凤泊	破镜重圆,覆水难收
腹笥甚窘	不学无术
缚鸡之力	摃鼎之能
摃鼎之能	缚鸡之力
附庸风雅	温文尔雅
付诸实施	片刻不离
片刻不离	付诸实施
废物利用	暴殄天物
暴殄天物	废物利用
飞扬拔扈	横行不法
横行不法	飞扬拔扈
纷至沓来	门庭冷落
分文不取	贪得无厌
修心养性	放浪形骸
飞蛾赴火	明哲保身
放纵不羁	严肃不苟
严肃不苟	放纵不羁
泛泛之交	患难之交
老态龙锺	返老还童
情深潭水	反面无情
反躬自责	诿过於人
诿过於人	反躬自责
凡夫俗子	仙风道骨,异士奇人
异士奇人	凡夫俗子
反覆无常	前後矛盾
前後矛盾	反覆无常
唾面自乾	虚己以听,反唇相稽
烦嚣喧闹	清幽静谧
清幽静谧	烦嚣喧闹
归	去
光	麻
麻	光
官	兵,民
乖	闹
闹	乖
鼓	瘪
够	亏
根	梢
刚	柔
柔	刚
枝	干
过之	不及
时髦	过时
过剩	不足
未来	过去
过量	极量
极量	过量,适量
过激	稳健
稳健	过激
过分	应分
应分	过分
过度	纵恣,适度
纵恣	发扬,过度
果真	料及,故意
故意	意外,果真,无意
果敢	懦弱
果腹	挨饿
挨饿	果腹
国语	方言,雅言
方言	国语
国有	共有,公有,私有
私有	国有
滚热	冰冷,冰凉
滚动	静止
贵重	低贱
国宴	家宴
家宴	国宴
国外	国内
国君	百姓
国际	国内
国防	民防
民防	国防
贵府	舍下
归俗	离俗
离俗	归俗
归拢	摊开
摊开	归拢
归还	借用
借用	归还,交还
归国	返国
返国	归国
归附	叛变,背离
归程	首途
首途	归程
广阔	褊狭,狭窄
广耕	精耕
精耕	广耕
广泛	狭窄
广大	狭小
狭小	广大,眇小,广博,开阔,汜博,宽阔,阔大,空阔
广博	狭小
沦陷	光复
官方	私方
私方	官方
官兵	胡匪
胡匪	官兵
可耻	光荣
光亮	暗淡,晦暗
惯例	经常
经常	偶尔,暂且,惯例
贯彻	抵制
管教	放纵
观测	推想
推想	观测
关上	开开,开,关闭,打开
关切	淡漠
淡漠	关切,热情
乖人	歹徒
歹徒	正人,乖人
乖气	戾气
戾气	乖气
乖僻	随和
寡断	迟疑
雇用	招聘
招聘	解雇,雇用
故友	新交
故舍	新居
新居	新房,故舍,故园
故入	故出
故出	故入
故去	在世
在世	故去,去世
故居	旧居
旧居	故居
故交	新知
新知	故交
规谏	忠告,劝阻
劝阻	指使,煽动,规谏,怂恿
归正	入邪
入邪	归正
归途	去路
去路	归途
归宿	到达
关门	开门
开门	关板,关门
关键	普遍
普遍	关键,个别,特殊
关东	关内
关板	开门
怪罪	谅解
怪异	端正
端正	怪异,不端
古装	时装
时装	古装
古制	新制
新制	古制
古语	新语
新语	古语
古文	白话
古书	新书,旧书
新书	古书
挂心	放心
挂念	忘怀
忘怀	挂念,记得,想念
挂记	放心
挂锄	开锄
开锄	挂锄
寡少	单独
寡情	多情
顾惜	珍惜
顾忌	放心
故宅	新房
新房	故宅,新居
故园	新居
固执	愚蒙,变通
固态	液态
液态	固态
固守	撤退
固然	但是
但是	虽然,固然
固辞	坚请
坚请	固辞,慨允
鼓噪	喧譁
喧譁	鼓噪
鼓舞	丧气
丧气	鼓舞
鼓励	压制
压制	鼓励,鼓动,反抗
鼓动	压制,阻碍
阻碍	鼓动,促使,畅通
鼓吹	禁遏
禁遏	鼓吹
蛊惑	针砭
针砭	蛊惑
骨子	夹里
夹里	骨子
古人	今人
今人	古人
古例	新例
新例	古例
新颖	老套,古老
古旧	破旧
古怪	平常
古风	今风
今风	古风
古板	开通
箍紧	松放
松放	箍紧
孤山	群峰
群峰	孤山
孤僻	随和,开朗
开朗	孤僻,抑郁,阴郁
孤癖	忧愁
购价	售价
售价	购价
构筑	摧毁
摧毁	建造,构筑
苟政	仁政
供应	消费
供水	断水
供给	无需
无需	供给
孤寂	热闹
姑息	严正
严正	姑息,随便
姑妈	姑爹
姑爹	姑妈
估计	确定
苟且	严格
严格	宽容,苟且
苟安	奋发
共和	专制
共管	独占
拱桥	平桥
平桥	拱桥
公众	公家
公章	私章
私章	公章
公债	私债
私债	公债
公允	不公,偏畸
公约	私约
私约	公约
公寓	私邸
公有	国有
私信	公函
公共	私家
私家	公共
公干	私事
私事	公差,私务,公事,公干
公愤	私仇
私仇	公愤
公法	私法
私法	公法
公营	私营
公意	私意
私意	公意
公学	私塾
私塾	公学
公心	私心
私心	公心
公务	公事
公事	公务,私事
公文	私函
私函	公文
公田	私田
私田	公田
公仆	老爷
老爷	公仆
公平	偏心
公立	私立
私立	公立
公空	领空
领空	公空
公德	私德
私德	公德
公产	私产
公差	私事
公布	隐瞒
工细	粗糙
工笔	意笔,写意
写意	工笔
梗阻	开放,畅通
梗直	阴险
耿直	圆滑,爽直,质直
圆滑	耿直
更始	革新
更改	照样,照旧
个展	联展
联展	个展
个体	群体,总体
群体	个体
个别	普遍,一般
格斗	和解
革命	反动
勾结	分裂
贡献	索取
共枕	独宿
共有	特有,国有
开垦	耕种
耕耘	种植
种植	耕耘
给与	赠给,领受
隔离	接近,隔开
接近	远隔,远离,隔离
隔开	隔离
隔绝	接触,相通
相通	隔绝,断绝
隔阂	倾轧
倾轧	隔阂
格外	一般
歌颂	推奖,诅咒,抨击,诽谤
歌唱	说白
说白	歌唱
搁置	抛弃
割让	收复
割据	统一
告终	开始
告诉	隐瞒
告借	借出
借出	收回,告借
告诫	听任
听任	告诫
根据	臆断
臆断	根据
根除	保留
各异	一律
一律	不同,各异
告发	包庇
告辞	相逢
告别	送别,见面
膏腴	贫瘠
高谈	耳语
耳语	高谈
高声	低声
高等	低等
高上	高尚
高山	幽谷
幽谷	高山
高妙	拙劣
高论	拙见
高峻	平坦
高就	屈就
屈就	高就
纲要	细目
细目	大纲,概要,纲要
纲领	大纲
大纲	略则,纲领,细目,总则
刚直	邪僻
邪僻	刚直,正大
刚正	偏斜
偏斜	刚正
刚硬	僵硬
刚毅	懦弱
刚烈	猛烈
猛烈	刚烈
刚健	柔美
柔美	刚健
刚愎	和顺
和顺	刚愎
感性	理性
理性	感性
感伤	欢娱
欢娱	感伤
感情	理智
感恩	报仇
干涉	放任
放任	约束,督促,看管,干涉,制止
协助	作梗,干扰,作对,干预
支渠	干渠
干流	合流
干将	庸才
干活	歇息
歇息	干活
干涸	湿润,润湿
感动	漠然
漠然	感动
赶走	遣散
赶上	落後
赶巧	不巧
赶紧	缓慢,拖延
甘愿	反对
甘休	不休
甘甜	苦涩
苦涩	甘甜,心酸,甜蜜
干预	协助
干线	主线
主线	干线,副线
干草	青草
青草	干草
干部	群众
概要	细目
概略	详情
详情	概略,概况
改善	恶化
改日	畴昔
畴昔	改日,异日
改进	守旧
改过	怙恶
怙恶	改过
改动	依旧
依旧	改变,改动
概况	详情,详细
盖住	显露
盖上	打开
盖然	绝不
绝不	盖然
改装	原装
原装	改装
改正	就范
就范	改正
改行	归队
交战	停火,媾和
赓续	中断
戆直	狡滑
狡滑	戆直,精明
尴尬	自然
挂一耭	包罗万象
共和国	民主国,君主国
君主国	共和国
公有制	私有制
私有制	公有制
公有林	私有林
私有林	公有林
公费生	自费生
自费生	公费生
工业国	农业国
农业国	工业国
搁得住	搁不住
搁不住	搁得住
高个儿	矮个儿
矮个儿	高个儿
戆小子	精灵鬼
精灵鬼	戆小子
过甚其词	恰如其分
过桥抽板	没齿不忘
没齿不忘	过桥抽板
过後行兵	坐失良机
过河抽板	恩图报
恩图报	过河抽板
裹足不进	勇往直前
国营企业	民营企业
民营企业	国营企业
鬼哭神号	鹊笑鸠舞
鹊笑鸠舞	鬼哭神号
鬼斧神工	粗制滥造
国富民安	民穷财尽,物阜民丰
物阜民丰	国富民安
诡计多端	勾心斗角
羞辱门楣	光宗耀祖
日月如梭	光阴似箭
贯彻始终	半途而废
纵观全局	管窥蠡测
冠盖高举	斯文扫地
关山迢递	近在咫尺
乖巧伶俐	呆头呆脑
寡见少闻	孤陋寡闻
强弱悬殊	寡不敌众
横加白眼	刮目相看
挂一漏万	面面俱到
面面俱到	顾此失彼,挂一漏万
寡情薄义	一往情深
顾虑重重	一无顾虑
一无顾虑	顾虑重重
顾此失彼	面面俱到
固定资本	流动资本
流动资本	固定资本
鼓勇直行	瞻前顾後
瞻前顾後	鼓勇直行
滾瓜溜圆	骨瘦如柴
古井重波	古井不波
古井不波	古井重波
古怪机灵	土头土脑
土头土脑	古怪机灵
古道热肠	人心不古
人心不古	古道热肠
孤行己见	一意孤行,顺风转舵
供过於求	供不应求,求过於供,生产过賸
求过於供	供过於求
攻无不克	不堪一击
孤孤零零	双双对对
双双对对	孤孤零零
曲学阿世	孤芳自赏
孤灯只影	人山人海
孤雏腐鼠	白璧明珠
白璧明珠	孤雏腐鼠
狗彘不若	超凡入圣
共存共荣	弱肉强食
恭谨谦和	骄矜狂妄
骄矜狂妄	恭谨谦和
功效如神	毫无效用
毫无效用	功效如神
公有财产	私有财产
私有财产	公有财产
公耳忘私	自私自利
功力悉敌	难与抗御
难与抗御	功力悉敌
公开选举	秘密选举
秘密选举	公开选举
公开外交	秘密外交
秘密外交	公开外交
更仆难数	屈指可数
各不相关	漠不关心
个人主义	集体主义
集体主义	个人主义
歌舞昇平	沧海横流
沧海横流	歌舞昇平,歌舞升平
共御外侮	入室操戈
入室操戈	共御外侮
耿耿於心	置之度外
耿耿於怀	九霄云外
九霄云外	无介於怀,耿耿於怀
各执一词	莫衷一是
诅咒 诋	歌功颂德
各怀鬼胎	同心同德
敛首低眉	高视阔步
高风峻节	卑鄙无耻
高枕而卧	枕戈待旦
高压手段	怀柔政策
怀柔政策	高压手段
高朋满座	门可罗雀,青蝇吊客
青蝇吊客	高朋满座
高高在上	深入实际
深入实际	高高在上
溜须拍马	刚直不阿
刚毅果决	当机立断
感性知识	理性知识
理性知识	感性知识
感同身受	漠不关心
无动於衷	心痒难熬,感人肺腑
感情用事	暴跳如雷
恨之入骨	感激涕零
感恩图报	没齿难忘,恩将仇报
敢作敢为	畏首畏尾
甘之如饴	悔之无及
改弦易辙	旧调重弹,习故守常,重蹈覆辙
改弦更张	旧调重弹,因循守旧
盖世功勋	弥天大罪
聒噪一时	绕梁三日
绕梁三日	聒噪一时
隔山观虎斗	扶危济困
火	水
旱	涝
涝	旱
害	益,利
火葬	土葬
土葬	水葬,火葬
火灾	水灾
水灾	旱灾,火灾
火速	缓慢
或然	必然
伙计	老板
老板	伙计
伙伴	敌人
活水	死水
死水	活水
活人	生人,死人
生人	熟人,活人
活命	诞生
诞生	逝世,活命
活路	出路,死路
出路	活路
活结	死扣
死扣	死结,活结
浑水	浊水
浊水	浑水,清水
祸水	福星
祸患	悲惨
祸害	造福
获罪	获咎
获咎	获罪,建功
获胜	得胜,败北
获利	得益
得益	损失,获利
遇难	获救,幸存,生还
昏沉	清醒明亮
清醒明亮	昏沉
昏暴	昏聩,英明
昏聩	昏暴,贤明
毁约	履约
毁言	誉言
誉言	毁言
毁灭	生存
毁坏	保护,修整
毁法	护法
护法	毁法
秽土	净土
净土	秽土
晦日	望日,朔日
望日	晦日
晦暗	光亮,晶莹
讳言	婉言
婉言	讳言,直言
汇集	分散
汇报	请示
悔恨	无悔
回训	请训
请训	回训
豁亮	昏暗
豁达	褊狭
褊狭	广阔,豁达,细切
清白	混浊
混杂	驳杂,纯粹
混合	分离
混沌	清晰
浑厚	清脆
荤食	素食
素食	荤食
荤菜	素菜
素菜	荤菜
昏庸	英明,贤达,贤明
英明	昏暴,昏庸
昏君	明君
明君	昏君
昏厥	苏醒
昏花	模糊
军	民
久	暂
暂	久
系	解
结	解
揭	捂
捂	揭
交	接
脚	头
俭	奢
奢	俭
己	彼
即	离
吉	凶
凶	吉
骏逸	平凡
骏驹	骞马
骞马	骏驹
掘起	蓬勃
蓬勃	衰落,掘起
倔起	衰落
绝望	无望,有望,如愿
如愿	失望,绝望
决骤	漫步
漫步	狂奔,决骤
决算	预算
预算	决算
捐献	索取
娟秀	丑陋
聚头	联袂,分手
俊敏	鲁钝
鲁钝	俊敏,伶俐,颖悟,颖慧
君主	贵族
军用	民用
民用	军用
绝情	死心
死心	绝情,迷恋
绝後	空前
空前	绝后,绝後
抉择	放弃
卷起	收拢
捐赠	索要
索要	捐赠
据实	凭空
凭空	据实,捏造
巨流	洪流
洪流	细流,巨流
巨额	大批
大批	少量,巨额,小数,少数
居家	回家
回家	居家
旧习	新风
旧书	古书
旧年	新年
新年	旧年
久远	短暂
久延	速成
速成	久延
鞠躬	立正
久候	少待
少待	久候
究责	体谅
体谅	究责
精湛	粗浅
精研	涉猎
涉猎	精读,精研,钻研
精雅	高雅
精心	疏忽
精通	略懂
纠合	解散
静养	活动
静心	分心
静卧	平静
静默	絮聒
絮聒	静默
敬意	蔑视
敬服	鄙视
敬称	谦称
敬爱	藐视
净重	毛重
毛重	净重
精明	糊涂,狡滑
精密	粗疏,致密
精美	粗陋
精练	冗长
精力	脑力,体力
体力	精力
精简	增设
增设	精简
精乖	聪颖
聪颖	精乖,愚昧
精读	涉猎,浏览
浏览	精读,审阅
精粹	通俗
精采	蹩脚
精辟	粗浅
精奥	显浅
显浅	精奥
教训	经验
经心	大意
经线	纬线
纬线	经线
警探	盗贼
盗贼	警探
警觉	麻痹
警戒	信赖
景仰	鄙视
紊乱	井然
精熟	耕种
灵魂	肉体,精神
精深	肤浅
惊醒	沉醉
沉醉	惊醒
惊恐	安详
惊悸	安定
惊惶	镇定
惊骇	袒
袒	惊骇
惊愕	镇定
荆棘	顺利
禁绝	同意
进场	出场
落伍	进步,先进
进兵	退兵
退兵	退军,进兵
进入	进来,退出
进款	支款
支款	提款,进款
紧要	重要,主要
紧缩	扩展,放宽,敛缩
紧密	松懈,松散
紧急	缓慢
紧促	余裕
余裕	紧促
紧闭	张开
张开	闭合,紧闭
统统	仅仅
今世	今生
今生	今世,来生
戒严	解严
解严	戒严
戒菸	抽菸
抽菸	戒菸
解雇	招聘,罢免
束缚	解脱,解放
竭力	敷衍
竭蹶	富裕
浸湿	晒乾
晒乾	浸湿
进展	停顿,停滞
停顿	进展
进行	终止,停止
进位	登位
登位	进位
近古	上古
上古	近古
近代	邃古,远古
邃古	近代
劲敌	弱敌
弱敌	劲敌
尽兴	扫兴
尽头	终点
尽情	活泼
谨严	松散
结业	始业
始业	卒业,结业
结盟	树敌,结好
结好	结盟,失和
结局	肇端,开端,开始
结婚	仳离
仳离	离婚,结婚
失和	结好
结冰	解冻
结巴	凝滞
霉黑	洁白,污黑
节略	详尽
节流	浪费
今日	当年,另日
今後	当前
当前	今後
今后	以前
以前	以後,以后,今后
巾帼	须眉
须眉	裙钗,裙衩,巾帼
解任	任命
解开	捆绑
捆绑	系结,解开
解酒	醉酒
醉酒	解酒
截止	开始
节制	抑制
节余	亏空
节用	撙节
撙节	节用,浪费
揭示	暴露
接续	断绝
接通	切断
切断	接通
接纳	推辞
推辞	接受,接纳
接见	访问
访问	接见
接风	饯行
饯行	接风,洗尘
教员	学员
学员	教员
教授	学生
教师	学生
脚注	眉批
眉批	旁注,夹注,脚注
脚下	头顶
头顶	脚下
角门	正门
角落	中央
角斗	搏斗
焦灼	安详
焦躁	安稳
焦虑	冷静
骄凌	争持
争持	谦让,骄凌
骄矜	谦虚
骄横	谦恭
谦恭	傲慢,骄横,冒昧,专横
浇薄	淳厚
娇艳	老丑
老丑	娇艳,丑拙
搅散	拢齐
拢齐	搅散
搅和	分开
矫捷	迟钝
矫健	蹒跚
蹒跚	矫健
狡饰	坦白
坦白	狡饰,隐瞒,隐讳
狡赖	否认
谦抑	骄恣
娇小	臃肿
臃肿	娇小
郊野	郊外
郊外	市区,郊野
停火	交战
交还	借用
交好	和好
讲话	发言
讲和	联欢,议和
议和	讲和
僵化	灵活
僵持	和解
降职	升职
升职	升任,降职
降下	升上,降落
降生	去世
降旗	升旗
升旗	降旗
降价	跌价,提价
跌价	降价,减价,落价,涨价
降格	升格
升格	降格
降服	反抗
降调	升调
升调	降调
升高	降低
讲理	蛮横
将领	士兵
将军	士兵
践踏	爱护
渐进	急进,保守
渐渐	逐渐
逐渐	马上,突然,渐渐
减削	省减,增加
减损	增益,损害
减速	放慢
加快	减慢,放慢
减价	跌价,特价
减法	加法
加法	减法
兼顾	专顾
专顾	兼顾
艰贞	再醮
再醮	艰贞
艰涩	流畅
艰钜	轻易
轻易	着意,艰钜,艰巨
艰巨	轻易
健壮	虚弱,衰弱
健在	去世,丧命
健忘	难忘
难忘	健忘,强记
健硕	羸弱
贱视	蔑视
贱民	劣民
劣民	良民,贱民,莠民
建造	摧毁
建功	获咎
硷性	酸性
酸性	硷性
坚决	迟疑,犹豫
坚持	放弃
见外	熟络,熟落
熟落	见外
简约	烦琐
简要	详细
简慢	怠慢
怠慢	倨傲,厚待,殷懃,简慢
检讨	反省
反省	检讨
检束	放浪
放浪	检束
减租	加租
加租	减租
减压	加压
加压	减压
减薪	加薪
加薪	减薪
捡到	拾起
拾起	捡到
俭约	奢华
俭省	浪费
俭仆	奢侈
拣到	拾遗,拾获,寻获,拾得
寻获	失踪,拣到
专职	兼职
兼用	专用
专用	通用,兼用
兼营	专营
专营	兼营
兼修	专修
专修	兼修
间歇	停止
间隔	连续
连续	间断,间隔
坚贞	守节
坚毅	懦弱
坚守	进攻
坚实	薄弱
坚韧	松脆,脆弱
松脆	坚韧
尖脐	团脐
团脐	尖脐
基础	尖端,顶端
忠实	奸诈
奸贼	忠臣
忠臣	奸贼,奸臣
奸邪	正直,狡猾
奸险	憨厚
憨厚	狡诈,奸险
假寓	定居
假心	假意,真心
真象	假象
假想	事实
假相	真相
假伪	可疑
架设	埋设
埋设	架设
架空	支撑
支撑	架空
嘉名	美名
嘉勉	惩处
家居	旅行
旅行	家居
佳肴	残羹
残羹	佳肴
加速	延缓
加入	轻便,投入
加热	冷却
冷却	加热
加劲	懈劲
懈劲	加劲
加价	涨价
涨价	跌价,加价
寄籍	原籍
原籍	寄籍,客籍
寂然	嚣然
嚣然	寂然,轰然
寂寥	热闹
奸商	殷商
殷商	奸商
奸人	好人
奸佞	贤良,贤才
贤才	奸佞
奸滑	忠厚
奸刁	滑头
滑头	奸刁
奸臣	忠臣
假名	本名
假冒	冒充,真确
真确	假冒,虚假
假话	谎信
谎信	假话
假发	真发
真发	假发
家乡	异乡
佳货	妙品
妙品	佳货
佳儿	孽种
孽种	佳儿
夹注	眉批
加多	增多
增多	加多,减少
加倍	折半
折半	加倍
寄信	收信
收信	寄信
记取	忘记
记起	牢记
牢记	记起,遗忘
计算	阴谋
阴谋	计划,计算
计较	让步
让步	计较
疾走	缓行,急往
缓行	疾走
疾风	徐风
徐风	疾风
急往	疾走
急退	遽退,迈进
遽退	锐进,急退
急速	缓慢
极端	折中,中正
中正	极端
极度	适度
适度	极度,过度
继室	前妻
前妻	继室
继配	元配
继承	让与
让与	继承
济恶	助善
助善	济恶
既定	未定
未定	既定,已定
既成	未成
未成	既成
际遇	环境
环境	际遇
忌惮	拘谨
己方	我方,自己
羡慕	嫉妒,赞佩
集装	散装
集权	分权
集结	疏散
疏散	密集,集结
急趋	徐行
徐行	急趋
急迫	舒徐,从容
急忙	从容
急剧	缓慢
急进	渐进
急急	徐徐
徐徐	急急
急激	激化
激化	缓和,急激
急促	缓慢
急驰	狂奔
狂奔	漫步,急驰
急步	缓步
缓步	急步
即位	让位
让位	即位
吉兆	喜兆
喜兆	恶兆,吉兆
吉祥	不吉
吉事	喜事
吉日	凶日
凶日	吉日
吉人	好人
吉梦	恶梦
吉服	凶服
凶服	吉服,丧服
忌辰	生辰
生辰	忌辰,忌日
伎俩	本领
本领	伎俩
激荡	平静
激昂	消沉,低沉
畸形	正常
缉私	护税
护税	缉私,走私
基层	上层
上层	基层,下层
积攒	积累
积压	清理
清理	积压
积蓄	消耗,损耗
姬人	偏房
偏房	姬人,正室,正房,细姨
鸡口	牛後
牛後	鸡口
机智	迟钝
及第	落第
激增	锐减
锐减	激增
激越	低沉
激励	怂恿
怂恿	劝阻,激励
激发	打击
积善	积恶
积恶	积德,行恶,积善,造孽
积聚	分散
积德	积恶
积存	消费
机械	灵活
机敏	迟钝
拙笨	机灵,灵巧
机警	呆滞
呆滞	机警,活泼
机动	固定
饥馑	丰收
饥寒	饱暖
讥笑	表扬
讥诮	贬低
讥讽	称赞
讥刺	赞美
讥嘲	夸奖
賙济	榨取
榨取	賙济,厚待
矍铄	苍老
崛起	覆灭
锐进	遽退
倨傲	怠慢
迥异	雷同
雷同	迥异
皎洁	暗淡
佼佼	平庸
羁縻	放纵
矜夸	谦厚
谦厚	矜夸
矜持	谦虚
诘责	表扬
侏儒	巨人,僬侥
蹇滞	亨通
亨通	蹇滞
瘠土	肥土
肥土	良田,瘠土
瘠薄	肥沃
军用品	民用品
民用品	军用品
精装本	平装本
平装本	精装本
闹哄哄	静悄悄
经不起	经得起
经得起	经不起
禁得住	禁得起
禁得起	禁不住,禁不起,禁得住
禁不起	禁得起
禁不住	禁得起
交战国	参战国,中立国
参战国	交战国
交流电	直流电
直流电	交流电
急性子	慢性子
慢性子	急性子
急巴巴	慢腾腾,慢吞吞
积极性	消极性
消极性	积极性
举世知名	遯世无闻
遯世无闻	举世知名
举棋若定	当机立断
绝情反目	相敬如宾
绝难一见	寥寥无几
绝口不提	逢人便说
逢人便说	绝口不提
绝不相同	大同小异
绝不屈服	奴颜卑膝
奴颜卑膝	绝不屈服
据为己有	秘而不宣
据实直书	凭空捏造
凭空捏造	据实直书
举鼎绝膑	拔山扛鼎
拔山扛鼎	举鼎绝膑
旧态依然	面目一新
旧瓶新酒	脱胎换骨
沥血之仇	救命之恩
无介於怀	九霄云外
九鼎大吕	盈千累万
盈千累万	九鼎大吕,寥寥可数
精通文翰	目不识丁
静室幽居	稠人广众
径情直遂	事与愿违
糊涂颟顸	精明强干
迭床架屋	精兵简政
井臼亲操	废寝忘食
井井有理	乱七八糟
精神奕奕	精神焕发,没精打采
没精打采	兴高采烈,精神奕奕
萎靡不振	精神抖擞,神采飞扬,气宇轩昂
精疲力尽	精力旺盛
精力旺盛	精疲力尽
精摹细琢	谨小慎微
召梦催眠	惊心动魄
风止波停	惊涛骇浪
惊恐万分	不动声色,泰然自若
惊惶失措	临危不惧,镇定如常不惧,不动声色
镇定如常不惧	惊惶失措
初生之犊	惊弓之鸟
经验主义	理性主义
理性主义	经验主义
浸微浸消	寖明寖昌
寖明寖昌	浸微浸消
咫尺天涯	近在咫尺
金衣玉食	褴褛箪瓢
褴褛箪瓢	金衣玉食
金无足赤	百孔千疮
金人缄口	口若悬河
金瓯无缺	半壁江山
半壁江山	金瓯无缺
近水楼台	鞭长莫及
筋疲力竭	精力充沛
玉帛笙歌	金戈铁马
金刚怒目	和颜悦色,凛然难犯
剿抚兼施	斩尽杀绝
搅三搅四	不问不闻
不问不闻	搅三搅四
矫若游龙	狡如脱兔
狡如脱兔	矫若游龙
顺其自然	推波助流,矫揉造作
胶漆相融	水火不容
骄者必败	哀兵必胜
骄奢淫佚	刻苦奋斗,艰苦朴素
刻苦奋斗	骄奢淫逸,骄奢淫佚
交浅言深	话不投机
众矢之的	交口称誉,有口皆碑,怨声载道
信而有徵	将信将疑
江洋大盗	鼠窃狗盗
七步成诗	江郎才尽
轻财仗义	见利思义
贱如粪土	无价之宝
坚持到底	半途而废
宅心仁慈	尖酸刻薄
见闻广博	孤陋寡闻
见死不救	袖手旁观
见仁见智	所见略同
所见略同	见仁见智
见而色喜	触目惊心
缄口无言	侃侃而谈
间断不继	连绵不断
连绵不断	间断不继
嫁祸他人	作法自毙
假装好人	坦诚相待
寂寂无闻	鼎鼎大名
鼎鼎大名	寂寂无闻
嫁祸於人	作法自毙
假仁假意	虚情假意
家徒壁立	富可敌国
计上心头	大刀阔斧
机锋百出	木讷无言
木讷无言	机锋百出
饥肠辘辘	酒足饭饱
击节称赏	拍案怒骂
拍案怒骂	击节称赏
鍼芥相投	水火不容
爝火微光	泰山北斗
泰山北斗	爝火微光
狷介之士	饕餮之徒
饕餮之徒	狷介之士
涓涓归公	大饱私囊
泾渭严分	沆瀣一气
沆瀣一气	泾渭严分
馈赠	索取
溃退	挺进
窥伺	正视
正视	回避,窥伺
阔客	穷汉
穷汉	阔客
阔大	狭小
困苦	幸福
困境	顺境
顺境	逆境,困境
困惑	理解
理解	糊涂,困惑,懵懂
亏缺	盈溢
盈溢	亏缺
亏耗	盈积
盈积	亏耗
快快	慢慢
快车	慢车
慢车	快车
散步	快步
夸赞	斥责
斥责	夸赞,诅骂,表扬
狂态	常态
狂热	冷静,理智
狂放	收敛
狂暴	温和
匡算	细算
细算	匡算
款友	迎宾
迎宾	款友
宽宥	宽大
宽仁	怜恤
怜恤	残忍,宽仁
宽饶	严惩
宽和	缓慢
酷好	厌烦
苦雨	久旱
久旱	苦雨
苦事	乐事
乐事	苦事
心酸	苦涩
口信	书信
书信	口信
口轻	口重
口重	口轻
空勤	地
空阔	狭小
可乐	可哀
可哀	可乐
可敬	可鄙
可鄙	可敬
可悲	可怒,可叹
可叹	可悲
苦河	乐园
乐园	愁城,苦河
苦海	愁城
愁城	乐园,苦海
枯朽	繁荣
枯瘦	丰满
枯乾	乾涸
乾涸	枯乾
枯窘	富饶
枯竭	充沛
充沛	衰竭,枯竭
枯瘠	肥沃
青翠	枯黄
恐惧	无畏
无畏	丧胆,恐惧,勇敢
孔多	繁密
繁密	萧疏,繁茂,孔多
孔道	小径
小径	孔道,大道
空言	事实
空隙	紧凑
空额	缺额,满额
缺额	空额
空船	满船
满船	空船
可惜	幸好
幸好	可惜
可畏	可亲
可亲	可畏
可怒	可悲
科学	迷信
迷信	科学
苛严	宽大
苛待	薄待
看管	放任
考取	落选
抗御	攻击
亢奋	冷静,疲乏,疲惫
慨允	坚请,再留
客位	主位
主位	客位
客土	本土
客体	主体
主体	客体
客套	粗野
刻苦	懒惰
可知	未知
未知	可知
开源	浪用
浪用	开源
开台	散戏
散戏	开台
开首	结束
开设	关闭
开阔	狭隘,狭小
狭隘	开阔,坦荡
开会	散会
散会	开会
开花	花谢
花谢	开花
开动	停开
停开	停转,开动
鍼口	饶舌
饶舌	鍼口
颀长	矮小
匮缺	丰盛
犒赏	惩罚
快动作	慢动作
慢动作	快动作
快车道	慢车道
慢车道	快车道
宽绰绰	窄巴巴
窄巴巴	宽绰绰
苦日子	好日子
好日子	苦日子
口头语	书面语
书面语	口头语
哭咧咧	哭啼啼
看得起	看不起
看不起	看得起
开场白	压轴戏
压轴戏	开场白
困处泥涂	青云直上
亏折一空	获利倍蓗
获利倍蓗	亏折一空
旷世难逢	昙花一现
狂嫖滥赌	滥吃滥用
滥吃滥用	狂嫖滥赌,缩衣节食
口眼喎斜	其貌不扬
口血未乾	言而无信
口说无凭	有案可稽
有案可稽	口说无凭,无中生有
空前绝後	继往开来
继往开来	空前绝後
口角春风	咄咄逼人
口不择言	轻诺寡言
轻诺寡言	口不择言
可有可无	举足轻重
慷慨好施	一毛不拔
慷慨担承	藉辞推搪
藉辞推搪	慷慨担承
肯堂肯构	败业倾家
败业倾家	肯堂肯构
客如云集	门可罗雀
刻苦耐劳	贪安好逸
贪安好逸	好吃懒做,刻苦耐劳
骄奢淫逸	刻苦奋斗,艰苦朴素
刻划入微	浓墨重彩
克劝克俭	爱财如命
开朗明爽	蒙昧不清
蒙昧不清	开朗明爽
开高走高	开低走低
开低走低	开高走高
开高走低	开低走高
开低走高	开高走低
落	添
络	经
录	放
流	源
源	流
赖	好
落空	破灭
破灭	实现,落空
落价	跌价
倒退	前进,落后
落发	还俗
落成	动土
落潮	退潮
退潮	落潮,涨潮
得志	落拓
落索	冷落
落魄	潦倒
潦倒	落魄,发达
罗织	开脱
开脱	罗织
乾脆	罗嗦
罗列	包藏
论亡	复兴
沦落	荣达,发迹
略则	大纲
掠夺	赐予
乱国	治国
治国	乱国
绿旗	红旗
红旗	绿旗
陆产	海产
海产	陆产
庐舍	楼台
楼台	庐舍
隆盛	衰退
笼统	具体
龙锺	软弱
屡屡	每次
每次	屡屡
屡犯	累犯
屡次	偶尔
录用	罢免
录取	当选
陆续	中断
陆路	水路
水路	旱路,陆路
露骨	含蓄
露出	隐藏,遮盖
漏洞	完美
陋巷	名门
名门	陋巷
陋习	文明
陋室	寒家
寒家	蓬门,陋室
楼下	楼上
楼上	楼下
楼房	平房
平房	茅屋,楼房
楼顶	楼底下
楼底下	楼顶
垄断	竞争
竞争	垄断
留住	留下
留下	留住,迁移
流行	过时
流通	冻结
留意	留神
留神	麻痹,留意
留心	大意
迁移	留下
留难	麻烦
留恋	依恋
依恋	厌倦,留恋
留级	升级
留存	消失
流利	生硬
生硬	自然,流利,娴熟
另日	今日
肉体	体魄,灵魂
灵动	迟纯
迟纯	灵动
伶巧	奔放
伶利	机灵
吝惜	浪费
裂缝	平整
平整	裂缝,坎坷
烈焰	文火
文火	烈焰
烈性	平和
劣行	恶行
恶行	劣行,懿行
上品	低品,劣品
良民	劣民
劣马	骏马
劣酒	美酒
美酒	劣酒
劣匠	良工,拙匠
拙匠	劣匠
料及	果真
了局	未完
未完	了局
了解	生疏
了结	未了
未了	了结
了得	平常
令誉	美誉
美誉	令誉,丑名
凌辱	尊重
凌厉	微弱
凌晨	傍晚
凌逼	扶持
灵验	无效
吝鄙	节俭
凛冽	炎热
鳞集	星散
临了	後来,终末
後来	临了,先前
邻近	附近
邻接	远离
远离	邻接,接近,靠近
劣货	俗品,好货
好货	劣货
劣点	优点
优等	劣等
劣笔	名笔
名笔	劣笔
劣败	惨败,优胜
僚属	上司
凉气	暖气
凉决	闷热
凉风	热风
热风	凉风,冷风
良缘	孽缘
孽缘	良缘
良友	损友,益友
益友	良友
良医	庸医
庸医	神医,名医,良医
脸硬	脸软
脸软	脸硬
敛缩	紧缩
敛迹	招摇
招摇	敛迹
领前	随後
随後	领前
领导	群众
零星	密集
零碎	完整,系统
系统	零碎,零乱
零卖	批发,零售
零散	密集
零钱	整钞
整钞	零钱
零乱	整齐,系统
联欢	讲和
涟漪	静止
怜爱	憎恨
连作	轮作
轮作	连作
连绵	间断
连忙	缓慢
连结	拆开
连接	联接,脱节
量浅	狭量
狭量	量浅,小器
量变	质变
质变	量变
两全	分身
分身	两全
良习	恶习
良田	肥土
良善	凶恶
良马	宝马
转瞬	良久
良工	劣匠
良策	下策
下策	良策
良材	废物
恋新	怀旧
怀旧	恋新
廉洁	贪污
贪污	清廉,廉洁
廉价	高价
联谊	反目
联袂	聚头
联接	连接
连横	合纵
合纵	连横
连合	分开
连贯	脱节
俐落	拖沓
隶属	并立
立业	倾家
倾家	立业
立体	平面
平面	立体
立扇	台扇
历史	现状
现状	历史
利用	废弃
利他	利己
利己	利他
利市	倒霉
利空	利多
利多	利空
利害	和气
利便	阻梗
阻梗	利便
丽人	美人
丽都	朴质
朴质	丽都,褴褛
立刻	缓慢
立功	犯罪,犯过
厉害	和善
和善	厉害,凶恶
力争	力避
力衰	力盛
力盛	力强,力衰
力强	力盛,力弱
力弱	力强
离弃	攀附
攀附	离弃
离奇	平常
离间	撮合
冷笑	赞叹
赞叹	冷笑,挖苦
冷天	炎天
炎天	冷天
冷水	开水
冷泉	温泉
温泉	冷泉
勒紧	放松
乐意	拒绝
老样	时样
时样	老样
理论	实际
实际	理论
懵懂	醒目,理解
里头	外头
外头	里头
争夺	谦让,礼让
礼貌	唐突,失礼
离别	重逢
冷作	热作
热作	冷作
冷战	热战
热战	冷战
冷遇	薄待
冷浴	温浴
温浴	冷浴
冷血	热心
冷僻	热闹
冷门	热门
热门	冷门
冷酷	热情
冷觉	温觉
温觉	冷觉
明枪	冷箭
冷敷	热敷
热敷	冷敷
冷风	热风
类似	相反
乐天	厌世
厌世	乐观,乐天
乐趣	悲苦
老是	偶尔
老弱	老大
老大	老弱,少壮
黎明	黄昏,傍晚
离异	脱离
离心	异志
异志	离心,分心
离乡	还乡
还乡	离乡
离席	退席
退席	离席
离任	离职
老妇	老媪
老媪	老妇
丑拙	老丑
老辈	小辈
小辈	长辈,老辈
牢靠	松散
劳心	劳力
劳力	劳心
劳顿	休息
劳瘁	劳苦
劳苦	劳瘁,逸乐
懒怠	怠惰
蓝缕	鲜华
鲜华	蓝缕
拦截	护送
护送	拦截
朗读	默读
默读	朗读,低吟
狼藉	整齐
滥造	粗制
烂熟	生疏
来生	今生
来年	曩昔
曩昔	来年
来回	单程
垃圾	宝贝
弄脏	肮脏
弄坏	弄好
弄好	弄坏
噜苏	繁杂
繁杂	噜苏,单一
嘹亮	圆润,沙哑
罹难	蒙难
蒙难	罹难
邋遢	乾净,体面
乾净	邋遢,腌臢
凉丝丝	暖烘烘
零售商	批发商
批发商	零售商
暖和和	冷飕飕,冷冰冰
冷丝丝	暖烘烘
冷清清	热呼呼
热呼呼	冷清清
冷门货	热门货
热门货	冷门货
乐陶陶	气冲冲
气冲冲	兴冲冲,乐陶陶
老豆腐	嫩豆腐
嫩豆腐	老豆腐
来得及	来不及
来不及	来得及
纵逸酣嬉	励精图治
克已奉公	利欲熏心
利他主义	利己主义
利己主义	利他主义
立地成佛	罪不容诛,罪该万死,罪孽深重
厉行节约	铺张浪费
力所不及	不自量力
力求上进	发奋图强
发奋图强	力求上进
离奇曲折	平淡无奇
冷水浇头	兴高采烈
拖拖拉拉	雷厉风行
乐在其中	百无聊赖
深以为苦	乐此不疲
名	实
勉励	打击
晓色	暮色
暮景	曙色
曙色	暮景
幕前	幕後
幕後	幕前
募集	分发
目前	从前
木模	铁模
铁模	土模,木模
赶怠	母系
默默	喋喋
喋喋	默默
墨黑	漆黑
末梢	末端
末端	终端,末梢
末路	绝路
绝路	末路
末伏	头伏
末等	头挑
头挑	末等
抹黑	贴金,增辉
贴金	抹黑
目击	耳闻
目的	手段
手段	目的
母带	子带
子带	母带
谋食	谋道
谋道	谋食
谋生	寻死
寻死	谋生
末学	博学
末位	首位
首位	末位
末尾	起头
魔鬼	天使,恶魔
恶魔	魔鬼,天使
磨蹭	麻利
麻利	缓慢,磨蹭
摩平	揉皱
揉皱	摩平
摩登	现代
请求	命令
明示	露面
明世	乱世
谋杀	他杀
默契	分歧
默念	诵读
诵读	默念
明见	卓见
阳沟	明沟
明旦	天黑,天亮
天亮	破晓,明旦
明达	变通
明澈	浑浊
明察	臆测
臆测	明察
名誉	光荣
名义	表面
名医	庸医
名言	胡说
胡说	名言
名人	凡夫
敏锐	迟钝
敏感	麻木
麻木	清醒,敏感
模型	实物
实物	原形,模型
模拟	独创
创造	模仿
摹拟	独创
摹仿	独创
铭记	萦思
萦思	铭记,淡忘
渺视	尊重
面子	表面
梦想	事实
梦境	浪漫
浪漫	梦境
梦幻	现实
蒙昧	文明
蒙懂	笨拙
没羞	大方
没事	有事
有事	没事
没趣	无味,乏味
冒失	谨慎
冒牌	正牌
正牌	杂牌,冒牌
冒昧	谦恭
冒犯	礼待
礼待	冒犯
冒渎	尊崇
尊崇	鄙视,冒渎,冒突
冒充	假冒
茂兴	零落
茅屋	平房
茅舍	琼楼
琼楼	茅舍
门楣	门槛
门槛	门楣
丑名	美誉
美意	恶意
美好	丑恶
每每	时时
时时	每每
污黑	霉黑
冒险	可靠
可靠	冒险
冒突	尊崇
毛布	细布
毛病	优点
满月	望月
买方	卖方
卖方	买方
买得	脱手
脱手	买得
埋怨	谅解
发掘	埋没
埋伏	暴露
莽撞	谨慎
盲目	自觉
自觉	盲目
忙乱	悠闲
悠闲	忙乱,匆忙,性急
蔓延	萎缩
萎缩	蔓延
漫骂	称颂
称颂	嘲笑,谩骂,漫骂
漫漶	清晰
慢步	快步
谩骂	称颂
渴望	满足
蛮荒	繁华
蛮干	巧干
巧干	蛮干
卖主	买主
买主	卖主
卖弄	谦虚
卖力	马虎
卖出	售卖,购买
迈进	急退
马上	暂缓,逐渐
颟顸	笨拙
眇小	狭小
腼腆	大方
醒目	模糊,懵懂
目的地	出发点
出发点	目的地
明晃晃	白茫茫
民主国	共和国
美男子	美女
美女	美男子
蒙蒙亮	麻麻黑
没信心	有把握
有把握	没信心
慢吞吞	慢腾腾,急巴巴
暮色苍茫	晨光熹微
晨光熹微	暮色苍茫
目无余子	虚怀若谷
木人石心	悲天悯人
默默无语	喋不休
喋不休	默默无语
棘棘不休	默默无言
默默无声	喋喋不休
默默不语	滔滔不绝
默不作声	夸夸其谈
墨守成法	别辟蹊径
末路穷途	柳暗花明
目中无人	虚怀若谷,平易近人
目空四海	虚怀若谷
目光短浅	高瞻远瞩
目不转睛	东张西望
东张西望	目不转睛
目不暇给	一目了然
谋为不轨	循规蹈矩
谋图不轨	循规蹈矩
漠然不动	心旌摇惑
心旌摇惑	漠然不动
恍然如悟	莫名其妙
命途坎坷	穷途潦倒
穷途潦倒	命途坎坷
命将就木	长生不老
长生不老	命将就木
谋定後动	谨小慎微
明火执仗	明目张胆
名誉扫地	籍籍无名
籍籍无名	名誉扫地
名位不彰	声名卓着
声名卓着	名位不彰,声誉卓着
名实难副	名不副实
名标青史	遗臭万年
鸣冤叫屈	心服口服
心服口服	鸣冤叫屈
名门淑女	小家碧玉
鳌头独占	名落孙山
名过其实	名不副实
万流景仰	民怨沸腾
民穷财尽	国富民安
面不改容	毛骨耸然,毛骨悚然,毛骨竦然,无所畏惧
面壁下帷	花天酒地
密密丛丛	稀稀拉拉
迷途知反	执迷不悟
灭此朝食	宋襄之仁
宋襄之仁	灭此朝食
妙手斲轮	相机行事
面面俱圆	八面玲珑
红光满面	形容枯槁,面黄肌瘦
秘密交易	公开交易
公开交易	秘密交易
迷路羔羊	识途老马
迷而知反	迷不知反
迷不知反	迷而知反,迷不知返
迷不知返	迷不知反
猛着先鞭	瞠乎其後
瞠乎其後	猛着先鞭
怏怏不乐	闷闷不乐
美酒嘉肴	饮冰茹蘖
饮冰茹蘖	美酒嘉肴
孟浪轻狂	临深履薄
临深履薄	孟浪轻狂
没完没了	一了百了
没世不忘	过河拆桥
没身不忘	过河拆桥
没没无闻	藉藉无名
藉藉无名	没没无闻
没精打彩	精神焕发
冒昧从事	草率从事,三思而行
草率从事	冒昧从事
茅室土阶	千金一掷
千金一掷	茅室土阶
门无杂宾	来者不拒
门堪罗雀	门可罗雀
门户相当	门当户对
门户大开	重门深锁
重门深锁	门户大开
美馔佳肴	山珍海味
每战皆北	望风披靡,战无不胜
每下愈况	江河日下
眉眼不开	眉开眼笑
蛇头鼠眼	眉清目秀
仪容可爱	面目可憎,眉目如画
没法没天	合情合理
没齿难忘	感恩图报
貌若无盐	花容月貌
冒险进取	逃避退缩
逃避退缩	冒险进取
毛毛腾腾	稳稳当当
稳稳当当	毛毛腾腾
毛举细故	提纲挈领
毛骨竦然	面不改容
毛骨耸然	面不改容
满目琳琅	空空如也
满坑满谷	不乏其人
满腹珠玑	博学多才
芒刺在背	袒自若
袒自若	芒刺在背,战战兢兢,镇定如常,周章狼狈
漫无目标	百步穿杨
漫无纪律	秩序井然
秩序井然	漫无纪律
漫山遍野	凤毛麟角
匆匆忙忙	慢条斯理
慢慢悠悠	慢条斯理,急急忙忙
满腹狐疑	半信半疑
满城风雨	一片祥和
一片祥和	一片详和,满城风雨
迈步猛进	踯躅不前
踯躅不前	迈步猛进
马虎从事	有板有眼
马齿徒增	老朽无用
老朽无用	马齿徒增
蔫	欢
匿	露
纳	出
虐政	暴政
女装	男装
男装	女装
女性	男性
男性	女性
挪后	提前
暖意	寒意
寒意	暖意
暖流	寒流
寒流	暖流
怒色	喜色
奴婢	主人
浓烈	清淡
宁靖	骚乱
骚乱	宁靖,安定
念旧	忘本
忘本	念旧
撵走	挽留
挽留	撵走
年尾	年初
怒气	喜气
喜气	怒气
怒放	开放,凋谢
努力	奋斗
奋斗	努力
奴役	自由
浓郁	清淡
浓缩	稀释
稀释	浓缩
凝视	无视
凝神	分心
融化	凝结,凝固
捏造	凭空
捏紧	松开,抓紧
鸟散	鸠集
鸠集	鸟散
酿祸	造福,造褔
年轻	年迈,年老
年迈	年轻
农村	城市
逆行	顺行
顺行	逆行
逆水	顺水
顺水	逆水
呐喊	低吟
闹争	失调
闹市	荒村
荒村	闹市
闹热	冷静,安静
闹翻	翻脸
翻脸	和好,闹翻
难免	未必
好看	难看
难解	浅显
难得	容易
难产	顺产
顺产	难产
难办	棘手,拿手
耐性	慢性
耐暑	耐热
耐热	耐暑,耐寒
耐寒	耐热
耐烦	厌烦
纳新	吐故
吐故	纳新
那边	这边
这边	那边
内助	外援
外援	内助
内债	外债
外债	内债
内在	外在
外在	内在
内忧	外患
外患	内患,内忧
内衣	外衣
外衣	内衣
逆流	顺流
顺流	逆流
逆境	顺境
能够	不能
能干	笨拙
能动	被动
脑力	精力
恼怒	高兴
恼恨	高兴
强记	难忘
难熬	难受
南方	北方
纳闷	明白
纳凉	取暖
取暖	纳凉
那样	这样
这样	那样
那时	现在
那里	这里
这里	那里
外表	内观,内心,内含
内销	外销
外销	内销
内线	外线
外线	内线
内情	外情
外情	内情
内皮	外皮
外皮	内皮
内面	外面
内乱	外乱
外乱	内乱
内力	外力
外力	内力
内里	表面
内科	外科
外科	内科
内角	外角
外角	内角
内间	外间
外间	内间
内患	外患
内涵	外延
外延	内涵
内含	外表
内观	外表
内服	外敷
外敷	内服
内耳	外耳
外耳	内耳
内查	外调
外调	内查
内层	外层
外层	内层
内部	外部
外部	内部
内标	外标
外标	内标
拿手	难办
搦战	迎战
迎战	搦战
驽骀	驽马
黏贴	剥离
女傧相	男傧相
男傧相	女傧相
怒冲冲	喜孜孜
喜孜孜	怒冲冲
凝固点	溶解点
溶解点	凝固点
拿得住	拿不住
拿不住	拿得住
蔫里巴唧	欢蹦乱跳
欢蹦乱跳	蔫里巴唧
暖气热气	冷气
女儿意态	铁石心肠
怒容满面	愁眉不展
偶数	奇数
奇数	偶数
破	立
贫	富
平安	危险
朴直	阴险
蒲柳	琼葩
琼葩	蒲柳
普及	提高
铺开	收拢,放开
扑灭	滋长,助长,点燃
仆役	主人
破晓	天亮
破损	完好
实现	破灭
破落	中兴
中兴	中落,破落
破烂	完美
泼辣	贤慧
平直	笔直
坎坷	平整
频频	偶尔
频繁	偶尔
贫士	富豪
贫人	贫民
贫民	富翁,贫人
飘荡	静止
飘泊	安定
漂摇	稳定
漂泊	安定
漂白	染黑
染黑	漂白
平易	艰深
平抑	镇压
平息	纷争
平时	有时,战时
有时	一向,平时
平板	呆板
贫窭	富有
贫寒	富裕
拼凑	拆散
飘逸	平庸
飘流	变动
飘开	聚合
聚合	飘开
飘浮	踏实
踏实	飘浮,札实
飘动	静止
偏向	公正
偏狭	苛刻
苛刻	偏狭
偏颇	偏袒,偏畸
偏见	不公
偏畸	公允,偏颇
疲劳	精神
疲倦	不倦
疲乏	亢奋
疲惫	亢奋
平乱	守法,作乱
平分	独吞
平放	倒立
平地	山地
山地	平地
僻静	喧闹
披露	隐藏
碰壁	一帆风顺
碰鼻	一帆风顺
蓬门	寒家
陪伴	单独
跑掉	抓住,放开
抛掷	摄取
摄取	抛掷
直系	旁系
庞杂	清纯
清纯	庞杂
盼望	失望
抨击	推奖,歌颂
赔帐	赚钱
培育	摧残
培养	摧残
陪同	独行
独行	陪同
收留	抛弃
胖子	瘦子
瘦子	胖子
旁注	眉批
叛逆	拥护
叛离	回归
叛变	归附
判定	否定
排尾	排头
排头	排尾
排挤	容纳
容纳	排挤
排队	插队
徘徊	果断
爬起	摔倒
摔倒	爬起
爬出	钻进
钻进	爬出
骈体	散体
散体	骈体
剽窃	原创
原创	剽窃
骈文	韵文
普遍性	特殊性
特殊性	普遍性
沦落户	破落户
碰钉子	一帆风顺
配角儿	主角儿
主角儿	配角儿
朴实无华	表里如一
铺张扬厉	平淡简单
平淡简单	铺张扬厉
仆仆风尘	深居简出
破涕为笑	敛笑而泣
敛笑而泣	破涕为笑
凭高望远	纵览全局,见多识广
评头评足	无可非议
破釜沉舟	急流勇进
泼天大胆	胆大包天
萍水相逢	分道扬镳
平直康庄	纡回曲折
纡回曲折	平直康庄
贫无立锥	家财万贯
平心易气	暴跳如雷
平心定气	暴跳如雷
偏狭小器	豁达大度
疲於奔命	捉襟见肘
平分秋色	独占鳌头,名落孙山
非驴非马	平淡无奇
屁滚尿流	所向披靡
披星戴月	玩岁愒时
玩岁愒时	披星戴月
披沙拣金	连毛带血
连毛带血	披沙拣金
盛饰严装	蓬头垢面
蓬蓬勃勃	冷冷落落
冷冷落落	蓬蓬勃勃
旁系亲属	直系亲属
直系亲属	旁系亲属
旁系血亲	直系血亲
直系血亲	旁系血亲
依然故我	判若两人
磐石之固	累卵之危
攀龙趋凤	伏枥守株
伏枥守株	攀龙趋凤
乐道安贫	攀龙附凤
嗤之以鼻	拍案叫绝
蚍蜉撼树	不自量力
颦眉蹙额	愁眉不展
取	存,舍
抢	让
欠	还
千	一
一	千,万
讫	起
谦	满
亲切	冷漠
裙钗	须眉
鹊起	鹘落
鹘落	鹊起
确认	否认
辱	荣
扔	接,拾
壤	霄,天
润湿	干涸
入学	退学
退学	入学
入睡	失眠
入神	分心
入侵	出击
出击	入侵
入梦	失眠
入来	出去
入口	出口
胀	缩
损	增
碎	整
押	赎
授	受
受	施,授
蚀	赚
施	受
剩	缺
赊	还
僧	俗
傻	精
簉室	发妻
属下	上司
缩手	伸手
伸手	缩手
缩减	补充,扩充
唆使	阻止
损友	良友
损失	收益,得益
岁终	年初
岁首	年终
岁入	岁出
岁出	岁入
岁暮	年初
素气	花哨
花哨	素气
素服	喜服
喜服	素服,丧服
艳丽	素淡,丑恶
颂歌	挽歌
挽歌	颂歌
颂辞	哀辞
所以	因为
因为	所以
随时	定时
定时	随时
随从	统领
统领	随从
虽然	但是
速决	延宕
延宕	速决
肃杀	凄凉
肃然	骚然
骚然	肃然
诉苦	说笑
说笑	诉苦
俗字	正字
俗语	雅语
雅语	俗语
俗趣	雅趣
雅趣	俗趣
俗品	劣货
俗念	雅意
雅意	俗念
俗名	学名
俗虑	雅兴
雅兴	俗虑
俗乐	雅乐
雅乐	俗乐
俗客	雅客
雅客	俗客
俗界	法界
俗歌	雅歌
雅歌	俗歌
搜购	推销
送别	告别
死人	活人
死灭	生息
生息	死灭
死结	死扣
松快	紧张
松开	捏紧
肆意	收敛
似乎	确定
伺候	虐待
四周	中央
死者	生者
生者	死者
出生	死亡,物化
死灰	繁殖
繁殖	死灰
死後	生前
生前	死後
死党	死敌
死别	生别
生别	生离,死别
撕裂	补合
私物	公物
私务	私事
说理	用武
用武	说理
说话	发言
说合	谗间
顺服	抗拒
抗拒	顺服,服从
顺风	顶风
顺畅	转折
转折	顺畅
撕毁	签订
签订	撕毁
嘶哑	清脆,响亮
斯须	良久
斯文	粗鲁
思想	行动
行动	思想
思旧	怀新
怀新	思旧
私宅	私邸
私用	公用
朔日	晦日
瞬息	良久
顺序	颠倒
颠倒	顺序
顺遂	波折
睡着	醒来
醒来	睡着
睡醒	觉醒
觉醒	睡眠,睡醒,沉睡
睡眠	觉醒
水葬	土葬
旱灾	水灾
水烟	旱烟
旱烟	水烟
水洗	乾洗
乾洗	水洗
爽直	耿直
数量	质数
质数	数量
庶民	贵族
庶出	嫡出
嫡出	庶出
熟铜	生铜
生铜	熟铜
熟铁	生铁
生铁	熟铁
熟食	生食
生食	熟食
熟人	生人
熟皮	生皮
生皮	熟皮
熟络	见外
熟路	生路
熟菜	生菜
生菜	熟菜
水田	旱田
旱田	水田
水平	垂直
旱路	水路
水涝	乾旱
乾旱	水涝
爽朗	阴暗
阴暗	爽朗,明亮
双方	片面
衰运	厄运
衰颜	白发
衰翁	壮丁
壮丁	衰翁
衰微	繁荣
衰颓	壮健
衰世	盛世
衰竭	充沛
树敌	结盟
暑气	寒气
寒气	暑气
暑假	寒假
寒假	暑假
熟字	生字
生字	熟字
输血	抽血
抽血	输血
输诚	顽抗
舒展	蜷缩
舒徐	急迫
舒坦	憋闭
憋闭	舒坦
舒缓	缓慢
忧闷	舒畅
亲密	疏远
疏慢	恳挚
恳挚	疏慢
疏漏	马虎
疏濬	淤塞
疏间	生疏
淑女	贤妻
贤妻	淑女
授奖	受奖
售卖	卖出
售货	退货
退货	出仓,售货
兽性	人性
人性	兽性
兽类	禽兽
禽兽	畜牲,兽类
受业	授业
授业	受业
收容	遣送
遣送	收容
收纳	收入
收进	支付
支付	收进,领取
瘦削	肥胖
授与	剥夺
授予	赋予
授赏	受罚
受赏	受罚
雪耻	受辱
受命	免职
受教	施教
施教	受教
手下	头领
头领	手下
手排	自排
自排	手排
收益	损失
收押	释放
收效	无效
收尾	起头
收束	推广
推广	收束
收工	出工
收费	免费
免费	收费
栽种	收成
收兵	续战
续战	收兵
收笔	起笔
适应	不适
不适	适应
适量	极量
事後	事前
受动	被动
首要	次要
起初	首先,最初,最先,最后
守拙	取巧
取巧	守拙
市街	田野
田野	市街
市恩	树怨
树怨	市恩
仕宦	仕官
仕官	仕宦
世交	世仇
世仇	世交
世间	阴间
阴间	阳间,世间
天真	世故
视觉	听觉
侍奉	虐待
储备	使用
史实	传奇
实干	空谈
实词	虚词
虚词	实词
实报	虚报
虚报	实报
识相	讨厌
时式	老式
失踪	寻获
失责	黩职
黩职	失责
失意	得意
得意	惆怅,失意
失仪	多礼
失入	失出
失出	失入
失却	获得
失密	保密
失落	找着,消失
拾遗	拣到
拾获	拣到
拾得	拣到
实战	演习
演习	实战,实践
实在	空洞
空洞	实在
实行	废除
实心	空心
空心	实心
实线	虚线
虚线	实线
实岁	虚岁
实权	虚名
实录	杜撰
杜撰	实录
实境	幻梦
幻梦	实境
十足	毫无
毫无	十足
十全	欠缺
施工	竣工
师父	徒弟
失业	就业
就业	失业
失实	真实
失神	提神
提神	失神
失常	正常
圣人	凡夫
圣洁	污秽
污秽	圣洁,清洁,干净
省悟	觉悟
省钱	费钱
费钱	省钱
声张	掩盖
声旁	形旁
形旁	声旁
生地	熟地
生离	生别
升空	降落
升火	点火
点火	升火
盛装	轻装
轻装	盛装
盛暑	严冬
盛情	冷漠
省劲	省力
省减	减削
生年	卒年
卒年	生年
生火	熄火
熄火	生火
生3	师
生2	熟
生1	死
升任	升职
升上	降下
审阅	浏览
神医	庸医
深邃	肤浅
深情	仇狠
仇狠	深情
深切	淡薄
深长	肤浅
神话	事实
深知	浅知
浅知	深知
深造	初学
初学	深造
深渊	浅濑
浅濑	深渊
伸腰	哈腰
哈腰	伸腰
申冤	含冤
尚在	已去
已去	尚在
尚未	还来
还来	尚未
上肢	下肢
下肢	上肢
上首	下首
下首	上首
上手	下手
下手	上手,主角
上去	上来
上来	上去,下来,下去
上前	後退
後退	上前
上联	下联
下联	上联
上课	下课
下课	上课
上界	下界
下界	上界
商议	独断
商谈	闲谈
闲谈	商谈
商量	争吵
争吵	和好,商量
申辩	妥协
少壮	老大
少小	年长
年长	少小
少数	大批,无数
少顷	半晌
半晌	少顷
善政	暴政
善行	懿行
懿行	善行,恶行
善心	歹意
善果	恶果
恶果	善果
善待	欺压
欺压	善待
善变	拘泥
善报	好报
山珍	山味
山味	山珍
山麓	山顶
山顶	山麓
山岭	山峰
上院	下院
下院	上院
上游	下游
下游	上游
上旬	下旬
下旬	上旬
上学	放学
放学	上学
上弦	下弦
下弦	上弦
上文	下文
下文	上文
上位	下位
下位	上位
上头	下头
下头	上头
上家	下家
下家	上家
上工	下工
下工	上工
上方	下方
下方	上方
上等	低等
上床	起床
起床	上床
上乘	下乘
下乘	上乘
上车	下车
下车	上车
上朝	退朝
退朝	上朝
下层	上层
上边	下边
下边	上边
下发	上报
上班	放工
放工	上班,下班
闪烁	暗淡
山脚	山峰,顶峰
山脊	山峰
杀气	和气
丧胆	无畏
散夥	合股
散股	独资
煞尾	开头
通红	煞白
傻气	聪明
骚闹	寂静
塞外	塞内
塞内	塞外
塞进	掏出
掏出	塞进
坦诚	撒谎
姗姗	匆匆
邃密	粗疏
夙昔	将来
汜博	狭小
死扣儿	活扣儿
活扣儿	死扣儿
死火山	活火山
活火山	死火山
死亡率	出生率
出生率	死亡率
熟石灰	生石灰
生石灰	熟石灰
受话器	发话器
发话器	受话器
生产者	消费者
消费者	生产者
上水道	下水道
下水道	上水道
上等货	珍贵品
珍贵品	蹩脚货,上等货
上半晌	下半晌
下半晌	上半晌
缩衣节食	滥吃滥用
缩头缩脑	挺身而出
损人利已	自私自利
遂非愎谏	刚愎自用
随意弃置	什袭珍藏
什袭珍藏	随意弃置
随俗沉浮	愤世嫉俗
风声鹤唳	所向披靡
所谋辄左	得心应手
粟红贯朽	灾歉连年
灾歉连年	粟红贯朽
文思泉涌	搜索枯肠
四面受敌	左右逢源
四海承平	天下多故
天下多故	四海承平
四处碰壁	八面玲珑
回心转意	死心塌地,心存魏阙
死灰复然	一蹶不振
说一是一	轻诺寡信
顺风转舵	孤行己见
推波助流	顺其自然
爽爽快快	啰啰嗦嗦
啰啰嗦嗦	爽爽快快
移风移俗	世风日下
势同水火	如胶似漆
市侩乡愚	骚人墨客
始料不及	意料中事
意料中事	始料不及
食言而肥	言而有信
时日无多	来日方长
时日不多	前程有限
前程有限	时日不多
实心实意	虚情假意
实物交易	现金交易
现金交易	实物交易
十分困难	十分容易
十分容易	十分困难
圣人巨人	君子
声誉卓着	声名卓着
声誉大增	名满天下
声气相通	不相闻问
不相闻问	声气相通
声彻云霄	阗寂无声
阗寂无声	鸦雀无声,声彻云霄
一息奄奄	生气勃勃
生动有趣	活色生香
活色生香	生动有趣
生产过賸	供过於求
慎重其事	视同儿戏
深居高拱	浪迹江湖
浪迹江湖	深居高拱
深厚之交	患难之交
深更半夜	日正当中
日正当中	深更半夜
神态自如	形色仓皇
形色仓皇	神态自如
神色沮丧	意气风发
浅而易见	深不可测
深奥无极	肤浅至极
肤浅至极	深奥无极
身无分文	腰缠万贯
身无长物	富可敌国
社会科学	自然科学
自然科学	社会科学
上情下达	下情上达
下情上达	上情下达
舍生忘死	贪生怕死
舍己救人	自顾不暇,损人利己
舍己从人	各持己见
上下同弃	雅俗共赏
雅俗共赏	上下同弃
伤痕累累	完好无损
森森草树	濯濯牛山
濯濯牛山	森森草树
桑榆之境	襁褓之年
襁褓之年	桑榆之境
三战三北	所向无敌
三元及第	累试不中
累试不中	三元及第
三心两意	一心一意
膻腥之气	兰麝之香
兰麝之香	膻腥之气
驷不及舌	令出如山
令出如山	驷不及舌
失节变节再醮	守节
徒	师
土	洋
洋	土,中
讨	还
唾骂	赞美
脱掉	穿着
穿着	脱掉
脱党	入党
入党	脱党
脱班	正点
拖延	赶紧
清偿	拖欠
拖拉	拖沓
退後	向前
向前	退後
推搪	应承
应承	推搪
推举	自荐
推奖	抨击,揄扬,歌颂
推後	押後,推迟
推迟	推後,提前
推断	断定
断定	疑惑,推断
推宕	阻挠
阻挠	推宕,成全
推戴	反对
推崇	誉扬,诋毁
诋毁	推崇
突兀	凹陷
突围	围困
围困	突围
突然	逐步,逐渐
逐步	骤然,猛然,突然
偷税	上税
痛心	喜慰
喜慰	痛心
痛恨	酷爱,热爱,锺爱
脱销	滞销
脱位	复位
复位	脱位
脱色	褪色
褪色	脱色
退役	入伍
从军	退伍
退位	登基
登基	退位
退守	进取
退军	退兵
出仓	退货
退会	入会
入会	退会
团聚	离散
吐露	掩盖
土气	潇洒,萧洒,洋气
洋气	土气
土模	铁模
土产	洋货
透露	封锁
透澈	浮泛
透辟	肤浅
投射	直射
直射	反射,投射
投入	加入
投放	回笼
投标	中标
中标	投标
同论	异论
同类	异类
异类	同类
同级	下级
同化	分化
通顺	别扭
通盘	局部
通例	变例
通航	停航
挺直	弯曲
挺身	退却
挺拔	弯曲
停转	停开
停战	开火
开火	停战
停用	启用
停学	复学
停留	前进
铁汉	懦夫
跳级	升级
挑战	应战
应战	挑战
挑唆	劝解
劝解	挑唆
挑开	分解
田园	都市
都市	田园
添加	削除
削除	添加
同种	异种
异种	同种
同性	异性
异性	同性
同姓	他姓
他姓	异姓,同姓
同乡	故乡
同体	异体
异体	同体
同情	嘲笑
同胞	本族
同伴	外人
外人	同伴
逃避	面对
面对	逃避
躺下	起来
起来	躺下
倘若	一定
天文	地理
地理	天文
天使	魔鬼,恶魔
天神	天主
天主	天神
人工	天然
天晴	下雨
下雨	天晴
天籁	地籁
地籁	天籁
天黑	明旦
体育	德育
体魄	肉体
体面	丢脸,邋遢
讨巧	费力
讨价	还价
淘汰	选送
选送	淘汰
陶醉	清醒
逃脱	擒获
逃离	回归
唐突	礼貌
唐塞	负责
汤面	乾面
乾面	汤面
探望	回避
袒露	包藏
袒护	检举,揭发
坦途	险途
险途	坦途
坦平	崎岖
坦率	暴露
坦露	暴露
坦荡	狭隘
摊还	徵借
摊分	独占
清廉	贪污
贪恋	迷恋
提醒	隐瞒
提价	降价
提防	疏忽
提出	撤回,反对
提拔	抬举,贬职
剔除	排泄
腾贵	上涨
上涨	腾贵,下跌
腾达	没落
特有	共有
特价	减价,削价
特地	顺便,专诚
特等	非凡
太重	太轻
太轻	太重
异姓	他姓
他乡	故乡,他方
他方	他乡
他动	被迫
太甚	恰好
恰好	太甚
太平	乱世
抬头	低头
抬举	提拔
挞伐	讨伐
蹧蹋	爱惜
佻达	佻巧
佻巧	佻达
堂堂皇皇	明目张胆
贪污舞弊	饮马投钱
饮马投钱	贪污舞弊
腾捷飞升	栖迟困抑
栖迟困抑	腾捷飞升
特立独行	顶天立地
泰山磐石	虎尾春冰
虎尾春冰	泰山磐石
兵连祸结	太平盛世
太平盖世	天下太平
太仓一粟	车载斗量
抬头挺胸	八面威风
八面威风	抬头挺胸
踏踏实实	好高骛远
韬光养晦	养晦韬光
养晦韬光	韬光养晦
我	敌
伪	真
危	安
万	一
弯	直
洼	高
误字	别字
物化	出生
芜杂	整洁
整洁	芜杂
芜浅	肤浅
芜秽	枯萎
无用	有用,万能
万能	无用
无益	有利,有害
无餍	不满
无厌	不足
无须	不必,必须
无心	有心
有心	无心,无意
无味	没趣
无理	有理
有理	无理
无礼	有礼
有礼	无礼
无关	有关
有关	无关,无干
我军	盟军
盟军	我军
我国	友邦
我方	己方
窝藏	检举
问题	成绩
稳重	浮躁,轻薄,轻浮
侮慢	尊敬
武士	武夫
武夫	武士
武庙	文庙
文庙	武庙
武断	审慎
审慎	武断
午时	子时
子时	午时
无望	绝望
无私	自私
自私	无私
无数	少数
无声	有声
有声	无声
无缺	残缺
无权	全权
全权	无权
无聊	有趣
无力	有力
有力	无力
无故	有因
有因	无故
无干	有关,相干
诬蔑	吹捧
吹捧	贬低,诬蔑
污水	清水
清水	污水,浊水
污名	清名
清名	污名
污吏	清官
谢	开
卸	装
斜	正
晓	夜
霄	壤
向	背
显	隐
响	答应
答应	拒绝,响
险	夷
夷	险
鲜	干
循私	秉公
询问	回答
回答	质问,询问
驯顺	倔强
驯善	平和
驯良	顽劣
遗弃	寻找
寻得	找出,寻找
殉国	叛国
绚丽	暗淡
绚烂	暗淡
选举	指定
指定	选举
悬念	放心
喧杂	鄙俗
喧嚣	沉寂,安静
喧阗	宁静
喧扰	阒然
阒然	喧扰
轩眉	侘傺
侘傺	轩眉
轩昂	平凡
蓄积	排放
排放	蓄积
续弦	再蘸,重婚,再嫁
重婚	续弦
续假	销假
销假	续假,请假
畜牲	禽兽
雄壮	衰弱
雄伟	渺小
丧服	凶服,喜服
凶暴	祥和,仁慈
性急	悠闲
灾难	幸福
幸存	遇难
醒悟	觉悟
醒觉	觉悟
新愁	旧恨
旧恨	新愁,新仇
新仇	旧恨
虚浮	切实,诚恳,真切
诚恳	虚浮,险诈,虚伪
裙衩	须眉
秀气	粗笨
秀发	振作
朽散	稀疏
羞辱	光荣
羞愧	骄傲
羞耻	荣誉
修整	毁坏
行贿	受贿
受贿	行贿
行恶	积恶
星夜	黑夜
小童	老叟
老叟	小童
小数	大批
小局	大局
小计	合计
合计	小计
小号	宝号
小额	小量
小量	小额
小丑	懦夫
嚣张	谦让
谦让	争夺,嚣张,争持
轰然	嚣然
嚣浮	浮躁
请假	销假
萧索	繁荣
萧疏	繁密
萧瑟	繁荣
萧洒	土气
消遥	拘束
消瘦	肥胖
消遣	工作
消灭	产生
消弭	爆发
生产	消费
削价	特价
巷子	大路
大路	巷子
乡下	城市
陷溺	摆脱
陷落	收复
现世	来世
来世	下世,现世
显要	卑微
显示	隐藏
显明	模糊
显贵	卑微,微贱
嫌疑	信任
信任	嫌疑,疑心
嫌忌	嗜好
嗜好	嫌忌
想念	忘怀
响应	反对
享受	吃苦
受罪	享福
祥和	凶暴
详实	简略
镶嵌	拆卸
厢房	正房
香气	臭气
臭气	香气
异样	相同,正常
相生	相克
相克	相生
相聚	分手
相干	无干
互异	相反
相对	绝对
绝对	相对
相背	迎面
迎面	相背
险阻	平坦
险诈	诚恳
险胜	轻取
轻取	险胜
险恶	平和
显着	隐晦
显在	潜在
潜在	显在
咸味	甜味
甜味	咸味
贤能	愚笨
贤明	昏聩,昏庸
贤良	奸佞
贤达	昏庸
闲职	要职
要职	闲职
闲逸	忙碌
闲暇	忙碌
纤巧	粗笨
先王	後王
後王	先王
先头	后续
后续	先头,先遣
先遣	后续
先前	後来
先觉	後觉
後觉	先觉
先辈	后辈
后辈	祖先,先辈
闲散	繁忙
纤细	粗壮
纤弱	强悍,粗壮
仙人	凡人
夏历	公历
下装	卸装
下昼	上昼
上昼	下昼,下午,下战书
下野	上台,在官
上台	下台,下野
下乡	回城
回城	下乡
下午	上午,上昼
下世	来世
下去	上来
下品	低品
下落	上升
下流	高尚
下来	上来
细姨	偏房
细碎	完整
细人	僬侥
细切	褊狭
恶兆	喜兆
喜信	凶信
凶信	喜信
洗尘	饯行
袭击	护卫
护卫	袭击
熄灯	掌灯
掌灯	熄灯
稀有	常见
吸气	呼气
呼气	吸气
西医	中医
中医	西医
西药	中药
中药	西药
西画	国画
国画	西画
西服	中服
中服	西服
下风	上风
上风	下风
下等	低等
细密	粗疏
细流	洪流
系结	捆绑
喜联	挽联
挽联	喜联
洗净	洁净
稀奇	常见
稀落	凋零
稀饭	乾饭
乾饭	稀饭
牺牲	葬送,保全
息争	兴戎
兴戎	息争
息怒	发怒
发怒	息怒
息灭	点燃
昔时	以后
以后	昔时,以前
昔日	来日
希奇	平凡
希罕	平常
吸入	呼出
呼出	吸入
西风	东风
东风	西风
西餐	中餐
中餐	西餐
夕暮	朝晨
夕晖	夕阳
下班	放工
下2	上
小器	狭量
瞎撞	白撞
白撞	瞎撞
莠民	劣民
薰风	朔风
朔风	薰风
嬉游	怠惰
炫耀	谦逊
亵渎	鄙视
骁勇	寒怯
寒怯	骁勇
娴雅	庸俗
娴熟	生疏,生硬
娴静	好动
瑕玷	优点
雄赳赳	软绵绵
刑警队	侦缉队
侦缉队	刑警队
兴冲冲	气冲冲
想得通	想不通
想不通	想得通
香馥馥	香喷喷
下战书	上昼
下意识	有意识
拔苗助长	循序渐进
循规蹈距	推陈出新
循循善诱	引入歧途
引入歧途	循循善诱
絮絮不休	三言两语
心灰意懒	雄心勃勃,雄心壮志,斗志昂扬
雄心万丈	心灰意冷
凶暴隔膜	冷淡
哀矜勿喜	幸灾乐祸
雪泥鸿爪	云散烟消
云散烟消	雪泥鸿爪
学问渊博	才疏学浅
旭日初升	旭日东升
虚有其表	表里如一
休养生息	穷兵黩武
胸无城府	怀有鬼胎
怀有鬼胎	胸无城府
凶年饥岁	五谷丰登
形影相吊	形单影只
形销骨立	鸠形鹄面
形容枯槁	红光满面
心痒难熬	无动於衷
心绪恶劣	心神郁结,心花怒放
心神专注	心神恍惚,心神不定
心神恍惚	漫不经心,心神专注
心神郁结	心绪恶劣
心神不定	心神专注
心存魏阙	回心转意
朽木难雕	孺子可教
孺子可教	朽木难雕
坐立不安	行若无事,心安理得
兴师动众	偃旗息鼓
兴会淋漓	兴致勃勃
挟山超海	谈何容易
邪恶小人	老奸巨滑
老奸巨滑	正人君子,邪恶小人
心如止水	心旌摇曳
心旌摇曳	心如止水
诛求无厌	心满意足
心乱如麻	心安理得
通今博古	心领神会,一知半解
神不守舍	心旷神怡
心口合一	口是心非
心怀坦白	光明磊落
携手合作	分道扬镳
协力同心	同心同德
笑傲公卿	趾高气扬
孝子贤孙	不肖子孙
不肖子孙	孝子贤孙
小手小脚	大手大脚
小材大用	大材小用
言出法随	朝令夕改,萧规曹随
宵壤之别	天壤之别
显露头角	不露身手
祥和之气	暴戾之气
暴戾之气	祥和之气
相知恨晚	视如寇仇
视如寇仇	相见恨晚,相知恨晚
相去悬殊	半斤八两
相持不一	急转直下
险象环生	履险如夷
履险如夷	险象环生
鲜衣美食	褴褛簟瓢
褴褛簟瓢	鲜衣美食
纤纤弱质	赳赳雄风
赳赳雄风	纤纤弱质
仙风道骨	凡夫俗子
细心吟味	下马观花
粗针大线	细针密缕
喜逐颜开	愁眉不展
喜形於色	愁眉不展
喜上眉梢	忧心如焚
袭人故智	自出机杼
自出机杼	袭人故智
习故守常	改弦易辙
嘻皮笑脸	油头滑脑,一本正经
悲从中来	喜出望外
息影园林	东山再起
下笔淋漓	文不加点
文不加点	下笔淋漓
薰莸异器	薰莸同器
栩栩如生	泥塑木刻
泥塑木刻	栩栩如生
切齿咒骂	馨香祷祝
潇潇风雨	朗朗云天
朗朗云天	潇潇风雨
狭小窄小苛严	镇压
小人之交甘若醴	君子之交淡如水
君子之交淡如水	小人之交甘若醴
晕	醒
渊	天
誉	毁
愚	智
智	愚
益	害
中	洋,西
严	宽
毅然	犹豫
云散	云集
悦目	刺眼
月终	月初
月食	日食
日食	月食
月亮	太阳
远程	短途
缘故	结果
圆润	嘹亮
原主	新主
新主	原主
蕴蓄	收集
晕迷	迷乱
迷乱	晕迷
允洽	恰当
恰当	允洽
允诺	不允
约束	放任
怨恨	感激
远洋	近海
近海	远海,远洋
远眺	近观
近观	远眺
远视	近视
近视	远视
远亲	近亲,至亲
近亲	远亲
远期	近期
近期	远期
靠近	远离
远海	近海
远古	近代
远隔	接近
原形	实物
原谅	责备
责备	原谅,夸奖
渊深	浅薄
誉扬	推崇
裕如	富裕
预先	事后
雨天	阴天
阴天	晴天,雨天
愚忠	巧诈
巧诈	愚忠
愚直	老实
愚者	智者
智者	愚者
愚蒙	固执
愚见	卑见
愚钝	笨拙
愚策	巧计
巧计	愚策
忧郁	高兴,畅快,愉快
余盈	亏损
余暇	赋闲
余剩	短缺
余晖	残阳
淤滞	畅通
迂缓	缓慢
一向	有时
有情	无情
游玩	休息
优遇	薄待
优裕	困穷
困穷	优裕
优游	忙碌
优异	恶劣,低劣
优雅	粗鲁
优秀	拙劣,平庸
优闲	冗忙
冗忙	优闲
优胜	劣败
优柔	果断
优美	丑陋
硬席	软席
软席	硬席
硬体	软体
软体	硬体
硬化	软化
软化	硬化
颖悟	鲁钝
颖慧	鲁钝
营业	开业
英雄	懦夫
英物	庸才
英俊	丑陋
应徵	召集
应允	拒绝
应许	拒绝
应时	过时
隐匿	出现
隐秘	公开
隐讳	坦白
饮泣	号哭
号哭	饮泣
音译	意译
阴郁	开朗,明朗
阴雨	晴朗
晴朗	阴晦,阴雨
阴性	阳性
阳性	阴性
晴天	阴天
计划	阴谋
阴面	阳面
阳面	阴面
阴霾	阴晦
阴晦	晴朗,阴霾
阴凉	炎热
和煦	阴冷
阳间	阴间,阳世
友谊	敌意
友善	欺诈
欺诈	友善
友人	敌人
友情	敌意
淫荡	纯洁
殷实	空虚
殷懃	怠慢
殷勤	冷淡
阴寒	凉爽
阴沟	明沟
阴电	阳电
阳电	阴电
因循	革新
因袭	改革
诱惑	劝告
劝告	诱惑
成熟	幼稚
幼细	细小
右翼	左翼
左翼	右翼
右手	左手
左手	右手
右倾	左倾
左倾	右倾
右派	左派
左派	右派
右边	左边
左边	右边
有益	有害
有望	绝望
幽暗	明亮
以後	以前
已足	不足
已婚	未婚
未婚	已婚
已定	未定
逸乐	劳苦
益鸟	害鸟
害鸟	益鸟
益处	害处
益虫	害虫
害虫	益虫
抑郁	开朗
抑闷	烦闷
异族	本族
异域	故乡
异议	赞同
异说	定说
依约	失约
厌倦	依恋,热衷,迷恋
依靠	独立
依从	违背
一志	二心
二心	一志
一直	断续
一心	分心
意识	存在
存在	消失,意识
意料	不料
意笔	工笔
异日	畴昔
异人	凡人
异国	祖国
祖国	异国
异端	正统
正统	异端
义师	王师
王师	义师,义兵,义军
义军	王师
义兵	王师
倚赖	独立
疑心	信任
疑念	信念
信念	疑念
遗忘	牢记
遗少	遗老
遗老	遗少
移情	属意
移民	土著
土著	移民
一连	间断
一贯	偶然,偶尔
夜晚	白天
白天	夜晚
夜阑	清晨
夜间	黑夜
业余	专业
野外	城内
阳世	阳间
一时	镇日,持久
持久	镇日,一时
一日	终岁
终岁	一日
一切	部分
一瞥	审视
审视	一瞥
一面	全体
摇曳	静止
摇动	坚定
摇摆	固定
谣言	事实,真话
炎夏	隆冬
炎暑	严冬
炎风	寒风
寒风	炎风
炎方	北方
沿用	废除
沿习	变革
沿海	内地
严峻	和气
宽容	严格
延续	中断
延迟	提前
淹没	浮现
野史	正史
野生	栽培
栽培	野生
势必	也许
仰卧	伏卧
仰慕	鄙视
仰给	依赖
扬长	蹑蹀
蹑蹀	扬长
燕雀	鸿鹄
鸿鹄	燕雀
好战	厌战
厌恨	厌恶
滑稽	严肃
严守	违背
严热	酷暑
严明	旺盛
严酷	平和
雅言	国语
雅淡	浓丽
浓丽	雅淡
押後	推後
压尾	带头
带头	压尾
压力	张力
张力	压力
嬴余	亏损
夭折	长寿
赝鼎	真货
真货	赝鼎,真迹
晏起	早起
早起	晏起
偃蹇	骞举
骞举	偃蹇
腌臢	乾净
湮灭	出现
湮没	发现
賸余	齐备
齐备	賸余
燠热	炎热
窳陋	低劣
揄扬	推奖
醲郁	浅淡
浅淡	醲郁
辕下驹	出笼鸟
出笼鸟	辕下驹
语体文	文言文
文言文	语体文
硬骨头	软骨头
软骨头	硬骨头
硬绑绑	软绵绵
硬邦邦	软绵绵
有关系	妨碍
义务兵	志愿兵
志愿兵	义务兵
一会儿	好一阵
好一阵	一会儿
洋博士	土博士
土博士	洋博士
一神教	多神教
多神教	一神教
一面倒	骑墙式
骑墙式	一面倒
云英未嫁	罗敷有夫
罗敷有夫	云英未嫁
云泥之别	大同小异
云泥有别	寡不敌众
怨天忧人	任劳任怨
远近有名	默默无闻
鸳鸯反目	琴瑟不调
琴瑟不调	鸳鸯反目
两败俱伤	两全其美,玉石俱焚
与世浮沉	超然物外
与民争利	拔葵去织
拔葵去织	与民争利
鱼雁不绝	雁足传书
雁足传书	鱼雁不绝
有口难言	无可置辩
无可置辩	有口难言
一馈十起	游手好闲
油头滑脑	嘻皮笑脸
油头粉面	囚首垢面
囚首垢面	油头粉面
营营役役	舒舒适适
舒舒适适	营营役役
正直清廉	营私舞弊
吹毛求疵	隐恶扬善
嚎啕大哭	饮泣吞声
勇猛求进	故步自封
勇猛精进	标奇立异
卓卓铮铮	庸庸碌碌
庸人自扰	智者不惑
智者不惑	庸人自扰
樱桃小口	张吻如盆
张吻如盆	樱桃小口
措手不及	应付裕如
引经据典	不见经传
寅吃卯粮	捉襟见肘
因公忘私	以私废公
以私废公	因公忘私
又说又笑	一字一泪
一字一泪	又说又笑
七颠八倒	有条有理
量材录用	以貌取人
以怨报德	仁至义尽,以德报怨
以德报德	以德报怨
易於反掌	难於上天
难於上天	易於反掌
易牙之味	味同嚼蜡
异途同归	背道而驰
依人篱下	寄人篱下
依然如旧	今非昔比
依官仗势	为民请命
为民请命	依官仗势,倚官仗势
依草附木	独立自主
医药罔效	不可救药
衣冠鼎盛	书剑飘零
书剑飘零	衣冠鼎盛
一片详和	一片祥和
一木难支	众擎易举,众志成城
摇头摆脑	正襟危坐
摇旗呐喊	人声鼎沸
腰缠十万	不名一文
不名一文	腰缠十万
罪	功
足	亏
浊	清
仔	当心
当心	仔
捉	放
逐	迎
转	停
停	转
种	收
植	伐
支	收,塌
占	领
憎	爱
糟	好
砸	成
作主	作东
作东	作主,作客
作数	生效
作声	发言
作乱	平乱
作客	作东
作古	出世
作工	工作
作梗	协助,成全
作废	有效
遵照	违反
遵命	抗命
抗命	遵命
尊府	府上
最远	最近
最近	最远
最先	起初,最后
最佳	最坏
最坏	最好,最佳
最好	最坏
最后	起初,最先
最初	起初
钻研	涉猎
祖先	后辈,后裔
做事	休息
做声	沉默
座谈	会谈
会谈	座谈
坐下	起立
起立	坐下
坐视	参预
参预	坐视
坐牢	入狱
作恶	为善
为善	作恶
作对	协助
左迁	荣升
荣升	左迁,降级
醉心	宝爱
罪行	功绩
最终	最後
最後	最终
组织	个人
组成	瓦解
瓦解	组成
阻滞	通畅
阻逆	麻烦
阻隔	畅通
阻遏	通达
通达	阻遏
阻挡	放行
诅骂	斥责
卒业	始业
奏效	失效
走私	护税
走开	回去
回去	走开
走板	扣题
发扬	纵恣
纵轴	横轴
横轴	纵轴
纵越	横跨
横跨	纵越
纵线	横线
横线	纵线
纵容	制止
纵贯	横亘
横亘	纵贯
纵队	横队
横队	纵队
纵断	横断
横断	纵断
总则	大纲
总体	个体
总合	单一
总共	单独
自尊	自卑
自卑	自尊,自豪,自卓,自信,自大,自负
自卓	自卑
强制	自发,自愿
自信	自卑
自恃	虚心
自如	拘谨
人为	自然
自强	自馁
自馁	自强
自动	被迫
自大	自卑,谦虚
自傲	虚心
子夜	正午
子虚	真实
着重	忽视
忽视	着重
着意	轻易
着手	住手
住手	着手,入手
着陆	降落
着急	镇静
浊流	清流
清流	浊流
浊富	富裕
茁壮	枯萎
自谦	谦虚,自夸
自力	依赖
自夸	自谦
自豪	自卑
自费	公费
自发	强制
子代	亲代
亲代	子代
滋润	干燥
滋长	扑灭
拙作	大着
拙工	巧工
巧工	拙工
拙笔	妙手
妙手	拙笔
卓越	平凡
卓异	拙劣
专科	一般
专横	谦恭
专诚	特地
抓住	跑掉
祝贺	哀悼
祝福	诅咒
驻紮	开拔
开拔	驻紮
贮备	消耗
忽略	注意
逐出	侵入
侵入	逐出
猛然	逐步
珠玉	瓦砾
瓦砾	珠玉
珠算	心算
巨人	侏儒
朱颜	白发
朱门	寒门
骤然	逐步
重音	轻音
轻音	重音
重要	紧要
重言	轻诺
轻诺	重言
重水	轻水
轻水	重水
重伤	轻伤
轻伤	重创,重伤
重量	轻量
轻量	重量
重利	薄利
重建	创建
创建	重建
重活	轻活
轻活	重活
准时	误点
赘疣	至宝
至宝	赘疣,草芥
赘聚	星散
通用	专用
纯粹	混杂,专一
专心	分心
注释	正文
注视	漠视
助威	弹压
助恶	劝善
劝善	助恶
助长	抵制,扑灭
住宿	通
入手	住手
住持	沙弥
主流	支流
支流	主流
主干	枝叶,枝杈
枝叶	主干
咒骂	颂扬
周折	顺利
周详	粗略
周围	中心
周全	短缺
周密	粗疏
重大	轻微
重创	轻伤
中落	中兴,中衰
中衰	中落
中年	童年
智取	强攻
强攻	智取
智巧	愚拙
智慧	痴呆
窒碍	畅通
致密	精密
制伏	反抗
制订	废除,撤销
至愚	至贤
至贤	至愚
至善	至恶
至恶	至善
至亲	远亲
至好	死敌
直言	婉言
直行	横行
横行	直行
直写	横写
横写	直写
直书	曲笔
曲笔	直笔,直书
直排	横列
横列	直排
执迷	觉悟
知名	无名
枝桠	枝杈
枝杈	枝桠,主干
众多	稀少
锺爱	痛恨
终末	临了
终局	开始
终伏	头伏
终端	末端
终场	开始
忠告	规谏
中转	直达
直达	中转
质直	耿直
质疑	应答
应答	质疑
质问	回答
治权	政权
政权	治权
制品	原料
指摘	赞美
指责	赞扬,称许
指使	劝阻
指控	公诉
指导	请教
请教	指导
指斥	夸奖
不值	值得
直直	弯弯
弯弯	直直
直喻	明喻
明喻	直喻
直立	倒立
直斥	曲庇
曲庇	直斥
直笔	曲笔
执行	违抗
支离	完整集中
完整集中	支离
政府	人民
正直	奸邪
正义	罪恶
歧途	正途
正人	歹徒
正气	邪气
邪气	正气
正派	反派
正念	邪念
邪念	正念
正经	轻佻
正教	邪教
邪教	正教
正好	不巧
正当	失当
正大	邪僻
正本	复本
整体	局部,部分
整顿	维持
振兴	衰退
真正	虚假
真心	假意,假心
真像	幻影
幻影	真像
真切	虚浮
真迹	赝品,真货
赝品	真迹
贞洁	纯洁
蠕动	蛰伏
折中	极端
折射	反射
折扣	实价
实价	折扣
遮掩	揭露
战时	平时
睁开	闭着
争先	退后
退后	争先
争取	摈弃
争脸	丢脸
震动	静止
镇日	持久,一时
斩截	观望
观望	斩截
瞻仰	鄙视
粘稠	稀薄
债务	债权
债权	债务
窄巴	宽绰
厚待	怠慢,榨取
诈伪	笃实
笃实	诈伪
诈降	投诚
投诚	诈降,反叛
札实	踏实
扎营	拔营
扎实	漂浮
造孽	积恶
造就	摧残
造褔	酿祸
早退	迟到
迟到	早退
早上	晚上
早年	晚年
晚年	早年
早稻	晚稻
晚稻	早稻
晚间	早晨
真诚	虚伪
真笔	伪笔
伪笔	真笔
珍异	平庸
珍爱	鄙弃
遮盖	露出
遮蔽	暴露
肇端	结局
照样	更改
找着	失落
找出	寻得
招架	投降
招安	反抗
障碍	通畅
涨潮	退潮
占有	放弃
占领	撤离
崭露	出现
展现	隐藏
展开	收缩
渣滓	糟粕
赠送	璧还
璧还	赠送
赠给	给与
增值	贬值
增益	减损,保护
增色	出色
早餐	晚餐
晚餐	早餐
早班	晚班
晚班	早班
糟害	保护
遭罪	享福
葬送	牺牲
赞语	贬辞
贬辞	赞语
挖苦	赞叹,恭维
赞佩	羡慕
暂且	经常
暂缓	马上
再犯	累犯
灾年	荒年
增产	减产
责难	赞扬
责骂	夸奖
责罚	奖励
躁急	迟缓
攒聚	分散
在押	在逃,释放
在逃	在押
在俗	还俗
在家	外出
外出	在家
在官	下野
再蘸	续弦
再留	慨允
再嫁	续弦
杂牌	正牌
杂居	独居
独居	杂居
杂沓	纷乱
杂处	独处
独处	杂处
譁噪	喧闹
座上客	阶下囚
纵坐标	横坐标
横坐标	纵坐标
纵剖面	横剖面
横剖面	纵剖面
重重的	轻轻的
轻轻的	重重的
重沉沉	沉甸甸
沉甸甸	重沉沉
中立国	交战国
执政党	在野党
在野党	执政党
站住脚	站不住脚
站不住脚	站住脚
灶下婢	掌上珠
蹩脚货	珍贵品
战胜国	战败国
战败国	战胜国
坐井观天	高瞻远瞩
作舍道旁	成竹在胸
作舍道傍	胸中无数
作奸犯科	奉公守法
尊孔崇儒	循规蹈矩
坐卧不安	心安理得
作壁上观	置身其中
罪孽深重	立地成佛
罪该万死	立地成佛
纵览全局	凭高望远
自作自受	自得其乐,自找苦吃
自找苦吃	自得其乐,自作自受
自圆其说	自相矛盾
自相矛盾	言行一致,自圆其说
自行矛盾	言行一致
自相残杀	同室操戈
自投罗网	死里逃生
死里逃生	束手待毙,自投罗网
自取其祸	无妄之灾
斫伐过度	穷兵黩武
灼见真知	陈腔滥调
陈腔滥调	真知灼见,灼见真知
自立门庭	自立门户
自立门户	自立门庭,寄人篱下
自愧弗如	自惭形秽
自顾不暇	舍己救人
自给自足	仰给於人
仰给於人	自给自足
无路请缨	自告奋勇
自甘堕落	力争上游
自甘雌伏	和衷共济
锱铢必计	仗义疏财
无心进取	孜孜不倦
擢发难数	屈指可数
卓然自立	愤世嫉俗
重於泰山	轻於鸿毛
轻於鸿毛	重於泰山
重拾旧欢	分钗破镜
分钗破镜	重拾旧欢
壮志凌云	人穷志短
人穷志短	壮志凌云
专职本职	兼职
周章狼狈	袒自若
周旋到底	退避三舍
重振旗鼓	大张旗鼓
众醉独醒	愤世嫉俗
众口纷纭	莫衷一是
窒塞难行	七通八达
七通八达	窒塞难行
至死不悟	顿悟前非
顿悟前非	至死不悟
至当不移	不攻自破
直言无隐	谎话连篇
谎话连篇	直言无隐
知足不辱	得寸进尺
知恩图报	过河拆桥
知恩报恩	忘恩负义
众寡悬殊	势均力敌
钟鸣鼎食	筚门圭窦
筚门圭窦	钟鸣鼎食
忠贞不二	忠贞不渝,喜新厌旧
忠於所事	尽心竭力
忠厚老实	厚颜无耻
置之脑後	念念不忘
念念不忘	置之脑後
滞滞泥泥	痛痛快快
痛痛快快	滞滞泥泥,滞滞汲汲
滞滞汲汲	痛痛快快
治国安民	祸国殃民
趾高气昂	垂头拱手
垂头拱手	趾高气昂
指桑骂槐	直言不讳
指顾成功	速战速决
只影全无	寥寥无几
直捷爽快	投怀送抱
投怀送抱	直捷爽快
直捷了当	转弯抹角
如梦初醒	执迷不悟
完整无缺	支离破碎
之死靡它	心猿意马
正直无私	贪赃枉法
正正经经	正大光明
谑浪调笑	正言厉色
正色庄容	一本正经
正道直行	倒行逆施
整军经武	武备废弛
武备废弛	整军经武
镇定如常	袒自若
枕戈泣血	过河拆桥
真诚相见	开诚相见
战争贩子	和平使者
和平使者	战争贩子
震古铄今	无声无息
宅心仁厚	居心不良
居心不良	宅心仁厚
真诚相对	开诚相见
真材实料	土牛木马
土牛木马	真材实料
照猫画虎	千篇一律
昭冤申枉	含血喷人
含血喷人	昭冤申枉
仗势凌人	豪侠好义
豪侠好义	仗势凌人
龙眉凤眼	獐头鼠目
遭遇坎坷	愁色难遮
愁色难遮	遭遇坎坷
责重事繁	人尽其才
倜傥不羁	局促不安
譁众取宠	脚踏实地
智者千虑，必有一失	愚者千虑
开端	罢休,结局
陷入	摆脱
欺负	帮助
勃勃	疲敝
疲敝	勃勃
博大	贫乏
博得	丧失
丧失	获得,博得
博识	浅薄
捕获	释放
不齿	尊重
不屑	值得
不朽	磨灭
合浦珠还	不翼而飞
出人意料	不出所料
黎黑	苍白
岑寂	喧闹
拆穿	掩盖
超脱	参与,拘束
彻底	肤浅
沉静	热闹
新奇	陈腐
虚情	诚意
沾光	吃亏
持平	偏心
耻笑	赞扬
炽烈	温和
冲淡	增强
恩惠	仇恨
出奇	平常
触犯	遵守
创见	成见
成见	创见
垂死	新生
纯朴	浮华
戳穿	隐瞒
慈悲	凶恶
匆忙	悠闲
文静	粗鲁
促使	阻碍
存心	无意
错乱	正常
错落	整齐
打倒	建立
拉拢	打击,排斥
大胆	胆怯
胆怯	大胆
大概	详细
牛刀小试	大显身手
单调	丰富
担当	担负
逝世	诞生
当初	如今
如今	当初
倒闭	开张
点滴	许多
许多	点滴
兜揽	拒绝
抖擞	委靡
督促	放任
短小精悍	长篇累牍
噩梦	美梦
美梦	噩梦
鸿运	厄运
啰嗦	扼要
发窘	自然
发散	会聚
会聚	发散
乏累	轻松
翻悔	承认
烦恼	高兴
轻闲	繁忙
妨害	有利
非难	赞赏
飞奔	徐步
徐步	飞奔
飞速	缓慢
飞扬	飘落
飘落	飞扬
废止	建立
合拢	分开
风趣	枯燥
枯燥	风趣
否则	然则
然则	否则
入木三分	浮光掠影
富丽	简陋
复辟	革新
反叛	投诚,归顺
归来	离去
宽恕	归罪
寒冬	酷暑
好汉	懦夫
浩如烟海	寥若晨星
合成	分解
黑沉沉	亮堂堂
黑黢黢	白茫茫
齐齐整整	杂乱无章,横七竖八
横祸	洪福
洪福	横祸
后裔	祖先
欢畅	痛苦
魂飞魄散	泰然自若
静止j	活动
积年累月	一朝一夕
鸡飞狗窜	鸡犬不惊
记忆	忘却
忠诚	奸诈
啰唆	简洁
降临	消失
起飞	降落
尽善尽美	一无是处
停滞	进展
羊肠小道	康庄大道
绝后	空前
空想	现实
恐怖	安宁
苦唧唧	甜丝丝
甜蜜	苦涩
宽广	狭窄
亏本	盈利
拉长	缩短
来势汹汹	销声匿迹
劳动	休息
老奸巨猾	年高德劭
年高德劭	老奸巨猾
老套	新颖
乐天安命	怨天尤人
怜悯	残忍
宦囊饱满	两袖清风
龙腾虎跃	死气沉沉
荣达	沦落
一无所获	满载而归
í貌合神离	情投意合
情投意合	í貌合神离
猛跌	暴涨
灭亡	生存
增辉	抹黑
以牙还牙	逆来顺受
独占鳌头	平分秋色
歧视	尊重
借贷无门	乞浆得酒
一兵一卒	千军万马
潜藏	显现
强悍	纤弱
清澄	污浊
清新	陈腐
轻薄	稳重
煽动	劝阻
惹是生非	循规蹈矩
热火朝天	冷冷清清
热气腾腾	死气沉沉
人急智生	束手无策
任人惟亲	任人惟贤
任人惟贤	任人惟亲
散开	聚拢
顶峰	山脚
舍身	偷生
偷生	舍身
声振林木	万籁俱寂
生动	死板
时不我与	来日方长
食古不化	推陈出新
漏泄春光	守口如瓶
守望相助	以邻为壑
违拗	顺从
数见不鲜	昙花一现
天从人愿	难偿所愿
天理	人情
人情	天理
天时	地利
地利	天时
天网恢恢	逍遥法外
天灾	人祸
人祸	天灾
听话	调皮
突出	凹陷
推让	争抢
争抢	推让
推却	承受
颓靡	振奋
决裂	妥协
挖	填
填	挖
万籁俱静	人声鼎沸
雄心未死	万念俱灰
万寿无疆	行将就木
微薄	雄厚
神采飞扬	萎靡不振
倚官仗势	为民请命
闻风而逃	所向披靡
蜗步龟移	风驰电掣
无人问津	一呼百应
一呼百应	无人问津
愠色	喜色
相当	悬殊
响亮	嘶哑
意气用事	心平气和
郁郁寡欢	洋洋得意
热衷	厌倦
耀武扬威	弃甲曳兵
焕然一新	依然如故
一反常态	一如既往
永久	暂时
雨后送伞	雪中送炭
忠心赤胆	朝秦暮楚
征服	安抚
壮大	减弱
上午	下午
关掉	开,开开,打开
关了	打开
减小	加,增大,加大
加大	减小
增大	减小
调小	调大
调大	调小
小点	大点
大点	小点
小点儿	大点儿
大点儿	小点儿
调亮	调暗
调暗	调亮
最亮	最暗
最暗	最亮
最小	最大
最大	最小
最高	最低
最低	最高
制冷	制热
制热	制冷
开窗	关窗
关窗	开窗
开灯	关灯
关灯	开灯
红色	绿色
绿色	红色
白色	黑色
黑色	白色
再小	再大
再大	再小
开大	关小
关小	开大
开开	关上,关掉,关闭
调开	调关
调关	调开
调升	调降
调降	调升
