一	掖,衣,忆,溢,易,肄,疑,屹,亿,意,艺,邑,义,绎,医,议,揖,毅,夷,移,遗,亦,译,宜,益,蛇,逸,翼,漪,奕,姨,液,役,壹,依,胰,谊,艾,仪,伊,抑,疫,异,腋	椅,已,漪,蚁,矣,倚,以,尾
乙	椅,已,蚁,矣,倚,以,尾	掖,衣,忆,溢,易,肄,疑,屹,亿,意,艺,邑,义,绎,医,议,揖,毅,夷,移,遗,亦,译,宜,益,蛇,逸,翼,漪,奕,姨,液,役,壹,依,胰,谊,艾,仪,伊,抑,疫,异,腋
丁	怔,盯,蒸,正,钉,狰,争,睁,症,征,叮,筝,挣	定,厅,拯,正,钉,订,政,郑,鼎,证,锭,症,整,挣,顶
七	溪,凄,漆,妻,栖,柒,戚,欺	气,启,起,鳍,稽,其,崎,枝,弃,旗,脐,只,迄,器,泣,祈,期,乞,砌,歧,齐,棋,骑,奇,契,畦,汽,岂,企
乃	奈,奶	耐
九	酒,韭,久,灸,玖,纠	旧,救,疚,鸠,臼,舅,究,就,揪
了	辽,燎,料	肋,辽,聊,垃,疗,乐,缭,撩,僚,勒,嘹,寥,潦
二	贰,儿	耳,儿,尔,而,饵
人	任,仁,儿	刃,韧,纫,忍,认,赁
儿	任,人,仁,耳,二,尔,而	刃,韧,纫,贰,忍,耳,二,认,尔,饵,赁
入	辱,褥	儒,乳,如,蠕,女
八	捌,扒,芭,笆,巴,叭,疤,吧	爸,坝,耙,靶,罢,霸,跋,伯,拔,把
几	箕,其,稽,鸡,脊,居,肌,机,叽,讥,期,唧,激,饥,绩,济,积,基,己,奇,挤,畸,迹,给	吉,吃,技,即,圾,集,祭,嫉,冀,籍,借,际,级,寂,寄,系,剂,继,忌,击,极,季,记,纪,妓,辑,计,疾,既,及,急,鲫,骑,棘,荠
刀	叨	祷,蹈,导,到,岛,盗,捣,悼,倒,道,稻
刁	叼,雕,碉	吊,调,钓,掉
力	利,立,粒,隶,丽,砾,痢,莉,厉,例,俐,雳,吏,历,励,沥,荔,栗	哩,李,里,理,厘,璃,离,漓,篱,梨,犁,礼,狸,鲤,黎
匕	比,笔,彼,鄙	闭,币,毙,蔽,逼,碧,毕,避,璧,泌,壁,弊,鼻,辟,臂,庇,必
十	拾,石,提,什,蚀,射,食,实,硕,时	恃,失,适,誓,侍,始,虱,饰,嗜,士,式,拭,屎,事,示,室,尸,释,识,市,使,矢,世,驶,匙,势,史,师,是,湿,氏,视,狮,诗,柿,逝,施,试
卜	补,捕,舶,驳,膊,白,搏,脖,泊,渤,荸,哺,博,柏,勃,伯,薄	跛,簸,埠,怖,播,部,拨,剥,步,玻,般,不,布,簿,菠
又	佑,幼,右,诱,有	优,由,犹,油,幽,悠,游,忧,尤,邮,友
三	参	散,伞
下	厦,暇,夏,吓	侠,辖,虾,斜,狭,匣,挟,峡,瞎,霞,洽
丈	胀,长,杖,涨,障,帐,仗,账	樟,掌,张,彰,章
上	尚,赏,晌	裳,伤,汤,商
丸	完,顽,玩	弯,宛,挽,婉,碗,惋,万,腕,湾,晚,豌,娩
凡	矾,烦,樊,繁,帆	犯,泛,饭,番,贩,翻,范,反,返
久	酒,韭,灸,九,玖,纠	旧,救,疚,鸠,臼,舅,究,就,揪
么	邀,哟,麻,吆,妖,夭,腰,要,蟆	墨,乐,咬,默,蚂,姚,模,玛,陌,吗,遥,末,谣,沫,窑,莫,钥,淆,拗,骂,抹,摩,茉,马,摇,侥,码,蘑,摸,耀,妈,魔,肴,漠,脉,寞,磨,舀,摹,没,药,膜
也	野,冶	业,叶,谒,爷,咽,夜,射,页,椰
乞	起,稽,启,岂	气,崎,鳍,其,柒,枝,戚,弃,溪,旗,脐,只,迄,器,泣,欺,祈,期,漆,砌,栖,企,歧,七,凄,妻,棋,骑,奇,契,畦,汽,齐
于	隅,屋,污,愉,呜,巫,娱,榆,鱼,愚,予,恶,逾,渔,诬,乌,舆	狱,雨,屿,预,武,语,与,欲,芜,物,玉,御,吁,愈,豫,误,羽,侮,喻,勿,舞,无,五,寓,吴,誉,郁,坞,浴,域,裕,梧,务,迂,蜈,淤,雾,晤,育,宇,尉,鹉,谷,午,亡,芋,捂,悟,伍,遇
亡	无,梧,巫,蜈,王,吴,诬,芜	屋,枉,武,于,物,往,误,污,侮,汪,勿,呜,舞,五,乌,网,坞,务,望,雾,晤,忘,旺,妄,鹉,午,捂,恶,悟,伍
刃	韧,纫,任,认,赁	人,仁,儿,忍
勺	率,帅,数,蟀,烁,芍,硕	梢,哨,烧,少,绍,稍,说,捎,召
千	铅,嵌,迁,纤,牵,谦,签	浅,钱,遣,谴,钳,黔,歉,欠,干,潜,前
叉	插,差,喳	刹,茶,查,察,岔
口		寇,扣
土	吐	屠,凸,涂,兔,图,途,突,徒,秃
士	恃,适,誓,侍,饰,嗜,式,拭,事,示,室,释,识,市,使,世,势,是,氏,视,柿,逝,试	拾,石,提,失,射,始,虱,十,屎,尸,矢,什,驶,匙,实,史,食,师,硕,湿,蚀,狮,诗,时,施
夕	戏,细,隙,系	息,希,习,吸,行,席,溪,锡,稀,牺,膝,熙,犀,携,媳,洗,熄,西,悉,晰,喜,惜,栖,嬉,蟋,厘,析,昔,徙,畦,袭
大	带,逮,待,代,怠,贷,袋,戴	瘩,打,搭,歹,答,达,呆
女	乳,辱	儒,蠕,如,褥,入
子	紫,仔,滓,籽	吱,资,字,自,滋,姿,咨
寸		存,村
小	晓	哮,销,萧,嚣,啸,削,硝,酵,宵,校,肖,箫,学,消,效,孝,笑
尸	失,狮,诗,虱,师,施,湿	拾,石,恃,提,射,誓,侍,适,始,饰,嗜,士,十,式,拭,屎,事,示,室,释,识,市,使,矢,什,世,驶,匙,势,实,史,食,硕,是,氏,视,蚀,柿,逝,时,试
山	删,衫,扇,珊,杉	善,赡,陕,膳,擅,闪,单
川	穿	传,船,串,喘
工	蚣,功,宫,共,攻,红,弓,恭,躬,供,公	贡,巩,汞,矿,拱
己	脊,几,济,挤,给	吉,吃,技,即,圾,箕,其,稽,集,祭,冀,嫉,鸡,籍,借,际,级,居,寂,寄,肌,系,剂,继,机,忌,叽,击,讥,极,期,季,唧,激,饥,记,绩,纪,妓,辑,计,积,疾,既,基,及,急,鲫,骑,奇,畸,棘,迹,荠
已	椅,乙,蚁,矣,倚,以,尾	掖,衣,忆,溢,易,肄,疑,屹,一,亿,意,艺,议,邑,义,医,绎,揖,毅,夷,移,遗,亦,译,宜,益,蛇,逸,翼,漪,奕,姨,液,役,壹,依,谊,胰,艾,仪,伊,抑,疫,异,腋
巾	津,襟,筋,金,禁,今,浸,斤	近,仅,尽,晋,劲,锦,进,谨,紧
干	柑,钱,竿,甘,钳,肝,黔,杆,潜,前	敢,竿,甘,迁,歉,感,欠,铅,肝,柑,千,赶,谴,嵌,牵,橄,秆,浅,遣,纤,谦,签,杆
弓	蚣,功,宫,共,攻,红,恭,工,躬,供,公	贡,巩,汞,矿,拱
才	财,材,裁	彩,踩,睬,猜,菜,采
丑		稠,酬,愁,臭,筹,畴,绸,仇,抽
丐	溉,盖,概,钙	该,改
不	埠,怖,部,步,布,簿	补,捕,卜,哺
中	终,仲,忠,种,重,众,衷,盅,钟	肿
丰	疯,峰,风,蜂,讽,封,枫,锋	冯,奉,凤,逢,缝
丹	担,耽,单	石,淡,蛋,但,旦,诞,弹,氮,胆
之	吱,汁,蜘,织,支,肢,知,只,脂,芝,枝,氏	植,旨,直,值,置,滞,治,至,职,秩,殖,帜,智,趾,致,识,指,质,止,挚,酯,窒,纸,稚,执,掷,制,址,志,征
予	隅,羽,雨,屿,宇,愉,语,于,榆,鱼,愚,逾,渔,与,娱,舆	狱,预,欲,玉,御,愈,吁,豫,喻,寓,渔,誉,郁,域,浴,裕,迂,淤,育,尉,谷,芋,遇
云	耘,匀	蕴,运,韵,陨,员,酝,孕,允,晕
井	警,颈,景,阱	兢,静,晶,鲸,靖,惊,竟,精,境,更,睛,茎,径,京,劲,敬,荆,竞,净,镜,经
互	护,沪,户	糊,戏,壶,胡,许,乎,蝴,唬,葫,虎,湖,狐,呼,忽,弧
五	侮,武,鹉,舞,午,捂,伍	屋,于,诬,芜,物,误,污,勿,呜,无,吴,乌,坞,梧,务,蜈,雾,晤,巫,亡,恶,悟
仁	任,人,儿	刃,韧,纫,忍,认,赁
什	蛇,拾,石,提,射,蚀,食,实,硕,时,舌,十,甚	恃,失,适,誓,侍,始,虱,饰,嗜,士,式,社,拭,屎,事,示,设,室,尸,释,摄,识,赦,市,叶,使,矢,世,驶,匙,涉,势,奢,史,师,是,湿,氏,视,舍,狮,诗,赊,柿,逝,施,试
仆	葡,朴,脯,铺,扑,菩,蒲	瀑,普,圃,朴,脯,谱,葡,铺,扑,暴,浦,菩,蒲
仇	稠,酬,愁,求,畴,筹,绸,球,囚	丘,蚯,丑,臭,抽,龟,秋
仍		扔
今	津,巾,襟,筋,金,禁,浸,斤	近,仅,尽,晋,劲,锦,进,谨,紧
介	借,界,诫,芥,届,戒,解	街,结,揭,皆,阶,洁,杰,劫,捷,截,竭,接,姊,节,姐
元	援,缘,源,辕,猿,员,园,袁,圆,原	宛,远,怨,愿,院,冤,渊,鸳
允	陨	蕴,运,匀,云,韵,耘,员,酝,孕,晕
内		哪,馁
六	溜,陆,馏	留,瘤,刘,流,榴,铆,琉,柳,硫,泵
公	蚣,功,宫,共,攻,红,弓,恭,工,躬,供	贡,巩,汞,矿,拱
冗	茸	蓉,绒,融,熔,容,榕,溶,荣
凶	汹,兄,胸,匈	熊,雄
分	份,吩,忿,芬,粪,奋,纷,愤,氛	粉,坟,焚
切	窃,怯,契	茄,且
匀	云,耘	蕴,运,韵,陨,员,酝,孕,允,晕
勾	句,沟,钩	苟,狗,购,够,构,垢
勿	晤,误,坞,务,恶,悟,雾,物	屋,武,于,芜,污,侮,呜,无,舞,五,吴,乌,梧,蜈,鹉,午,巫,亡,捂,诬,伍
化	话,划,桦,华,画	滑,划,猾,豁,花,哗
匹	坏,霹,否,批,劈,被,披	疲,譬,脾,罢,啤,皮,僻,辟,屁
午	侮,武,鹉,舞,五,捂,伍	屋,于,诬,芜,物,误,污,勿,呜,无,吴,乌,坞,梧,务,蜈,雾,晤,巫,亡,恶,悟
升	生,胜,声,甥,牲,笙	绳,剩,乘,圣,省,盛
友	有	佑,又,由,犹,优,幽,油,悠,幼,诱,游,右,忧,尤,邮
及	吉,极,借,吃,脊,唧,即,急,圾,级,寂,集,辑,嫉,击,疾,棘,籍	技,几,箕,其,稽,祭,冀,鸡,际,居,肌,寄,系,剂,继,机,忌,叽,讥,期,季,激,饥,记,济,绩,纪,妓,荠,计,积,既,基,己,鲫,骑,奇,挤,畸,迹,给
反	返	犯,矾,凡,泛,烦,樊,番,饭,繁,翻,贩,范,帆
天	添	甜,恬,田,填,舔
夫	肤,幅,袱,拂,福,辐,符,麸,俘,蝠,敷,缚,伏,扶,服,孵,芙	甫,复,负,咐,腹,妇,辅,父,赋,附,付,抚,斧,赴,腐,脯,府,俯,富,傅,副
太	汰,态,泰	台,抬,胎,苔
夭	邀,咬,么,哟,舀,吆,妖,腰,要	遥,乐,谣,窑,钥,淆,拗,姚,耀,肴,药,摇,侥
孔	恐	控,空
少	绍,召,哨	芍,勺,梢,烧,稍,捎
尤	由,犹,油,游,邮	佑,又,优,幽,悠,幼,诱,右,忧,有,友
尺	齿,侈,耻	吃,池,嗤,持,翅,迟,驰,斥,匙,赤,弛
屯	囤,谆,臀	准,吞,褪
巴	捌,扒,笆,芭,叭,八,疤,吧	爸,坝,耙,靶,罢,霸,跋,伯,拔,把
幻	焕,痪,涣,唤,宦,患,换	环,还,缓,欢
引	隐,瘾,听,蚓,饮	因,姻,音,银,淫,吟,殷,印,茵,阴
心	芯,薪,新,辛,锌,欣	衅,信,寻
戈	搁,胳,鸽,疙,割,哥,歌	个,格,葛,阁,合,各,隔,革,蛤
户	护,沪,互	糊,戏,壶,胡,许,乎,蝴,唬,葫,虎,湖,狐,呼,忽,弧
手	首,守	寿,熟,收,瘦,售,授,受,兽
扎	炸,闸,喳,查,渣	眨,诈,乍,栅
支	吱,汁,蜘,织,肢,知,只,之,脂,芝,枝,氏	植,旨,直,值,置,滞,治,至,职,秩,殖,帜,智,趾,致,识,指,质,止,挚,窒,纸,稚,执,掷,制,址,志,征
文	紊,纹,问,蚊,免,闻	温,吻,稳,瘟
斗	蚪,豆,抖,读,陡,逗,痘	蚪,兜,抖,豆,读,陡,逗,都,痘
斤	津,巾,襟,筋,金,禁,今,浸	近,仅,尽,晋,劲,锦,进,谨,紧
方	坊,芳	妨,纺,仿,房,防,访,放,肪
月	乐,越,悦,钥,跃,耀,粤,阅,岳,药,说	约
木	沐,牧,幕,募,慕,睦,穆,暮,目,墓	姥,拇,牡,模,母,姆,亩
欠	纤,歉	浅,钱,铅,千,遣,谴,钳,嵌,迁,黔,牵,谦,签,干,潜,前
止	指,旨,只,址,纸,趾,征	植,汁,蜘,织,吱,知,直,值,置,芝,滞,治,枝,至,职,秩,殖,帜,只,之,智,致,识,质,挚,窒,脂,稚,氏,执,支,肢,掷,制,志
歹	逮	带,待,大,代,怠,贷,呆,袋,戴
比	闭,笔,币,毙,蔽,彼,碧,毕,泌,避,璧,匕,弊,臂,壁,辟,庇,鄙,必	逼,鼻
毛	锚,矛,茅	冒,猫,茂,贸,帽,貌
氏	吱,汁,蜘,织,知,恃,适,誓,侍,饰,嗜,士,芝,枝,式,拭,事,示,室,只,之,释,识,市,使,世,势,脂,是,视,支,肢,柿,逝,试	植,拾,石,失,提,旨,射,始,直,虱,值,置,滞,治,十,至,屎,职,秩,尸,帜,殖,智,趾,致,指,质,止,矢,挚,窒,什,驶,匙,实,史,食,硕,纸,师,稚,湿,执,掷,址,制,志,狮,诗,蚀,时,施,征
水		谁,税,蜕,说,睡
火	伙	活,霍,豁,惑,祸,货,获,和,或
爪	找,沼	罩,抓,招,着,朝,昭,赵,照,兆,召,嘲
父	甫,抚,赋,斧,复,负,咐,附,府,脯,妇,俯,副,赴,腹,辅,富,腐,付,傅	肤,幅,袱,拂,福,辐,符,麸,服,俘,浮,蝠,敷,缚,伏,扶,夫,孵,芙
片	骗,遍	便,偏,篇,扁,翩
牙	押,衙,涯,蚜,芽	哑,压,雅,轧,讶,呀,鸦,亚,鸭
牛		钮,纽,扭,拗
犬	卷,全,权,拳,痊,泉	圈,券,劝
王	忘,旺,妄,亡,望	往,汪,网,枉
丙	屏,禀,饼,秉,柄	兵,病,冰,并
世	恃,适,誓,侍,饰,嗜,士,式,拭,事,示,室,释,识,市,使,势,是,氏,视,柿,逝,试	拾,石,提,失,射,始,虱,十,屎,尸,矢,什,驶,匙,实,史,食,师,硕,湿,蚀,狮,诗,时,施
且		切,茄,契,怯,窃
丘	秋,龟,蚯	囚,求,仇,球
主	煮,拄,嘱,属,贮	柱,轴,蛀,逐,注,住,蛛,驻,珠,竹,诸,烛,助,朱,铸,株,术,猪,祝,筑
乍	栅,诈,炸	闸,喳,查,眨,渣,扎
乏	法,筏,阀,伐,罚	发
乎	戏,呼,忽	糊,壶,胡,护,蝴,唬,葫,沪,虎,互,湖,狐,许,户,弧
以	椅,已,乙,蚁,矣,倚,尾	掖,衣,忆,溢,易,肄,疑,屹,一,亿,意,艺,议,邑,义,医,绎,揖,毅,夷,移,遗,亦,译,宜,益,蛇,逸,翼,漪,奕,姨,液,役,壹,依,谊,胰,艾,仪,伊,抑,疫,异,腋
付	父,赋,复,附,咐,负,赴,富,妇,傅,腹,副	甫,辐,符,麸,缚,服,扶,辅,夫,孵,肤,福,俘,浮,蝠,抚,幅,斧,腐,芙,袱,拂,脯,府,俯,敷,伏
仔	紫,宰,滓,籽,载,子	吱,资,字,在,自,滋,灾,姿,栽,咨,再
仗	胀,丈,长,杖,涨,障,帐,账	樟,掌,张,彰,章
代	带,逮,待,大,怠,贷,袋,戴	呆,歹
令	另	铃,玲,凌,龄,零,领,菱,陵,翎,蛉,伶,岭,灵
仙	纤,掀,鲜,先	宪,闲,嫌,现,限,陷,咸,线,铣,弦,显,馅,癣,险,腺,衔,县,献,贤,涎,舷
充	冲	崇,宠,重,虫
兄	汹,凶,胸,匈	熊,雄
册	测,厕,策,侧	
冬	东	冻,懂,董,动,洞,栋
凹		傲,熬,澳,拗,懊,奥,袄
出	初	处,厨,触,橱,锄,础,雏,畜,楚,储,除,矗
凸	滑,屠,古,涂,图,谷,途,突,骨,徒,股,鼓,贾	雇,沽,告,兔,土,故,固,咕,吐,估,顾,家,姑,秃,孤,辜
刊	看,勘,堪	坎,砍
加	夹,佳,茄,嘉,家	夏,稼,价,假,驾,架,甲,挟,钾,嫁,荚,贾,颊
功	蚣,宫,共,攻,红,弓,恭,工,躬,供,公	贡,巩,汞,矿,拱
包	胞,褒,苞	暴,保,爆,刨,宝,雹,豹,饱,堡,抱,报,薄
匆	从,囱,聪,葱	丛
北		辈,杯,卑,备,贝,狈,碑,背,惫,焙,臂,倍,被,悲
半	伴,办,拌,瓣,绊,扮	版,班,板,扳,颁,搬,般,斑
卡	咳	哈,咖,恰,洽
占	站,毡,战,颤,暂,瞻,蘸,栈,沾,绽	盏,崭,展,斩
去	漆,娶,趣	圈,岖,蛆,取,趋,渠,驱,区,曲,躯,屈
躯	圈,岖,蛆,趋,驱,区,曲,屈	取,漆,渠,娶,趣,去
可	坷,刻,克,课,客,渴	颗,壳,棵,科,磕,咳,苛,蝌
古	滑,凸,谷,骨,股,鼓,贾	雇,沽,告,故,咕,固,估,顾,家,姑,孤,辜
右	佑,又,幼,诱,有	优,由,犹,油,幽,悠,游,忧,尤,邮,友
召	罩,招,着,朝,昭,哨,少,绍,赵,照,兆,嘲	沼,芍,勺,梢,找,烧,爪,稍,捎
叮	钉,盯,丁	定,订,鼎,锭,顶
叨	刀	祷,蹈,导,到,岛,盗,捣,悼,倒,道,稻
叼	雕,碉,刁	吊,调,钓,掉
司	私,撕,思,丝,斯,嘶	伺,肆,四,赐,食,饲,死,寺,似
叫	窖,教,觉,校,轿,较	焦,角,交,脚,剿,娇,蕉,狡,胶,侥,椒,骄,嚼,郊,饺,绞,搅,缴,矫,礁,浇
另	令	铃,玲,凌,龄,零,领,菱,陵,翎,蛉,伶,岭,灵
只	吱,汁,蜘,织,知,旨,崎,其,鳍,芝,枝,旗,脐,之,趾,指,祈,期,止,歧,纸,脂,氏,支,肢,棋,址,骑,奇,畦,征,齐	植,气,旨,启,直,柒,起,值,稽,置,治,滞,戚,至,弃,溪,职,秩,殖,帜,智,迄,器,泣,趾,致,识,欺,指,质,止,挚,乞,砌,栖,窒,漆,纸,七,稚,执,凄,妻,掷,制,志,址,汽,契,岂,征,企
史	屎,使,矢,始,驶	拾,石,恃,失,提,射,誓,侍,适,虱,饰,嗜,士,十,式,拭,事,示,室,尸,释,识,市,什,世,匙,势,实,硕,食,师,是,湿,氏,视,蚀,狮,诗,柿,逝,时,施,试
台	抬,苔	态,太,泰,汰,胎
句	拒,足,惧,巨,炬,俱,据,聚,沟,锯,勾,具,距,剧,钩	菊,驹,蛆,苟,沮,居,橘,拘,狗,购,够,车,鞠,举,局,构,矩,垢
叭	捌,扒,芭,笆,巴,八,疤,吧	爸,坝,耙,靶,罢,霸,跋,伯,拔,把
四	伺,肆,赐,食,饲,寺,似	私,撕,思,死,司,丝,斯,嘶
囚	求,仇,球	丘,秋,龟,蚯
央	秧,鸯,殃	养,阳,氧,扬,样,羊,漾,仰,洋,杨,痒
失	尸,狮,诗,虱,师,施,湿	拾,石,恃,提,射,誓,侍,适,始,饰,嗜,士,十,式,拭,屎,事,示,室,释,识,市,使,矢,什,世,驶,匙,势,实,史,食,硕,是,氏,视,蚀,柿,逝,时,试
奴		努,怒
奶	乃,奈	耐
孕	蕴,运,韵,员,酝,晕	匀,云,陨,耘,允
尼	呢,泥	你,匿,腻,拟,溺,逆
巨	拒,足,惧,炬,俱,据,聚,锯,句,具,距,剧	菊,蛆,沮,居,橘,车,鞠,矩,举,局,驹,拘
巧	鹊,悄,雀	峭,瞧,乔,窍,撬,壳,桥,敲,锹,侨,翘,俏,跷,憔
左		坐,座,凿,做,昨,作
市	恃,适,誓,侍,饰,嗜,士,式,拭,事,示,室,释,识,使,世,势,是,氏,视,柿,逝,试	拾,石,提,失,射,始,虱,十,屎,尸,矢,什,驶,匙,实,史,食,师,硕,湿,蚀,狮,诗,时,施
布	埠,怖,部,步,不,簿	补,捕,卜,哺
平	屏,冯,凭,苹,坪,评,萍,瓶	乒
幼	佑,又,右,诱,有	优,由,犹,油,幽,悠,游,忧,尤,邮,友
必	闭,币,毙,蔽,碧,毕,泌,避,璧,比,壁,弊,臂,辟,庇,鄙	笔,彼,逼,匕,鼻
打		瘩,搭,大,答,达
扔		仍
扒	捌,芭,笆,耙,巴,爬,叭,八,疤,吧	爸,坝,帕,靶,罢,霸,趴,跋,伯,怕,拔,把
扑	仆,铺	瀑,普,圃,朴,脯,谱,葡,仆,暴,浦,菩,蒲
斥	赤,翅	吃,池,嗤,持,齿,侈,耻,迟,驰,匙,尺,弛
旦	石,淡,蛋,但,诞,担,弹,氮	丹,耽,胆,单
术	述,轴,竖,逐,漱,数,曙,竹,束,烛,恕,树,墅,署,庶,筑,疏	柱,鼠,注,蜀,驻,主,朱,赎,珠,梳,暑,拄,蔬,铸,输,黍,薯,抒,煮,书,淑,属,嘱,猪,贮,蛀,枢,熟,住,蛛,叔,诸,舒,株,殊,助,祝
本		笨,奔
未	慰,胃,魏,尉,味,卫,位,喂,为,遗,谓,蔚,伪,畏	危,薇,萎,威,唯,苇,违,委,偎,围,微,伟,桅,巍,维,纬,尾
末	墨,寞,默,莫,沫,磨,膜,没,漠,茉,脉,陌	么,蘑,摸,摹,魔,抹,摩,模
正	怔,狰,睁,争,丁,政,郑,证,征,症,筝,挣,蒸	整,拯,丁
母	姥,拇,牡,姆,亩	沐,牧,幕,募,慕,睦,穆,暮,模,目,墓,木
民		皿,悯,敏,闽
永	咏,踊,蛹,泳,勇,拥	庸,用,佣
汁	吱,蜘,织,支,肢,知,只,之,脂,芝,枝,氏	植,旨,直,值,置,滞,治,至,职,秩,殖,帜,智,趾,致,识,指,质,止,挚,窒,纸,稚,执,掷,制,址,志,征
犯	泛,贩,范,饭	矾,凡,烦,樊,番,繁,翻,帆,反,返
玄	悬,还,漩,县,旋	炫,轩,喧,选,宣
玉	狱,预,语,欲,御,愈,吁,豫,喻,寓,誉,郁,浴,域,裕,育,尉,谷,芋,与,遇	隅,羽,宇,雨,屿,愉,于,迂,榆,鱼,予,逾,愚,淤,娱,舆
瓜	蜗,刮,括	褂,挂,卦,寡
瓦		挖,娃,袜,蛙,洼
甘	柑,杆,竿,肝,干	敢,杆,赶,感,秆,橄,干
生	身,胜,声,升,甥,牲,笙	绳,剩,乘,圣,省,盛
用	佣	庸,咏,踊,蛹,泳,勇,永,拥,佣
甩		率,帅,蟀,衰,摔
田	甜,恬,填	添,舔,天
由	犹,油,游,尤,邮	佑,又,优,幽,悠,幼,诱,右,忧,有,友
甲	夏,贾,钾,假	稼,价,夹,佳,驾,茄,架,挟,嫁,嘉,加,荚,家,颊
申	绅,身,深,信,呻,伸,参	肾,神,渗,审,沈,婶,甚,慎
白	舶,驳,膊,搏,脖,泊,渤,荸,卜,博,柏,勃,伯,薄	跛,簸,播,拨,剥,玻,般,拜,败,摆,百,菠
皮	疲,脾,罢,啤	坏,霹,譬,否,僻,批,辟,屁,劈,被,匹,披
皿	悯,敏,闽	民
目	沐,牧,幕,慕,睦,穆,暮,募,墓,木	姥,拇,牡,模,母,姆,亩
矛	锚,毛,茅	冒,猫,茂,贸,帽,貌
矢	屎,使,始,驶,史	拾,石,恃,失,提,射,誓,侍,适,虱,饰,嗜,士,十,式,拭,事,示,室,尸,释,识,市,什,世,匙,势,实,硕,食,师,是,湿,氏,视,蚀,狮,诗,柿,逝,时,施,试
石	拾,淡,提,蛋,旦,什,射,但,诞,蚀,担,时,实,硕,食,弹,氮,十	恃,失,适,誓,侍,始,虱,饰,嗜,士,胆,式,拭,屎,事,示,室,尸,释,耽,识,市,使,矢,世,驶,匙,势,史,师,是,单,氏,丹,湿,视,狮,诗,柿,逝,施,试
示	恃,适,誓,侍,饰,嗜,士,式,拭,事,室,释,识,市,使,世,势,是,氏,视,柿,逝,试	拾,石,提,失,射,始,虱,十,屎,尸,矢,什,驶,匙,实,史,食,师,硕,湿,蚀,狮,诗,时,施
禾	盒,何,荷,核,合,褐,盖,和,河	喝,呵,吓,赫,贺,鹤
穴	学,雪,削,血	靴,薛
立	利,粒,隶,力,丽,砾,痢,莉,厉,例,俐,雳,吏,历,励,沥,荔,栗	哩,李,里,理,厘,璃,离,漓,篱,梨,犁,礼,狸,鲤,黎
乒		屏,冯,坪,凭,苹,平,评,萍,瓶
乓	磅	膀,螃,庞,胖,旁
交	蕉,教,焦,椒,骄,郊,礁,浇,胶,娇	窖,搅,缴,叫,觉,轿,狡,矫,嚼,角,侥,校,脚,剿,较,饺,绞
亦	掖,衣,忆,溢,肄,易,屹,一,亿,意,艺,邑,义,绎,议,毅,译,益,逸,翼,奕,液,役,谊,艾,腋,抑,疫,异	已,乙,疑,倚,医,揖,夷,移,矣,遗,宜,尾,椅,蛇,漪,姨,壹,以,依,胰,仪,伊,蚁
亥	害,骇	咳,还,海,孩
仿	纺,访	妨,坊,房,防,芳,方,放,肪
伙	火	活,霍,豁,惑,祸,货,获,和,或
伊	依,医,揖,衣,漪,壹,一	掖,已,乙,忆,溢,易,肄,疑,倚,屹,亿,意,艺,议,邑,义,绎,毅,夷,移,矣,遗,亦,译,宜,益,尾,椅,蛇,逸,翼,奕,姨,液,役,以,谊,胰,艾,仪,蚁,抑,疫,异,腋
伍	侮,武,鹉,舞,午,五,捂	屋,于,诬,芜,物,误,污,勿,呜,无,吴,乌,坞,梧,务,蜈,雾,晤,巫,亡,恶,悟
伐	发,法,阀,筏,罚,乏	发
休	羞,修	绣,宿,臭,秀,锈,朽,嗅,袖
伏	袱,幅,拂,福,辐,俘,符,服,浮,蝠,缚,扶,夫,芙	甫,复,麸,负,咐,腹,妇,辅,孵,父,肤,赋,附,付,抚,斧,赴,腐,脯,府,俯,敷,富,傅,副
仲	种,重,中,众	终,忠,衷,肿,盅,钟
件	舰,健,箭,荐,剑,溅,见,贱,渐,键,监,践,间,建,涧,鉴	碱,肩,俭,茧,歼,艰,煎,奸,拣,减,剪,检,简,坚,兼,捡,尖,柬
任	刃,韧,纫,人,仁,认,儿,赁	忍
仰	养,痒,氧	央,杨,阳,扬,样,鸯,羊,漾,殃,秧,洋
份	忿,奋,粪,分,愤	吩,坟,芬,纷,粉,焚,氛
企	弃,气,妻,砌,迄,汽,契,器,泣	启,起,鳍,稽,柒,其,崎,枝,戚,溪,旗,脐,只,欺,祈,期,漆,乞,栖,歧,七,凄,棋,骑,奇,畦,岂,齐
光		逛,广
兆	赵,罩,照,召	沼,招,着,朝,昭,找,爪,嘲
先	纤,掀,仙,鲜	宪,闲,嫌,现,限,陷,咸,线,铣,弦,显,馅,癣,险,腺,衔,县,献,贤,涎,舷
全	卷,权,拳,痊,泉,犬	圈,券,劝
共	贡,蚣,宫,功,巩,拱,汞,攻,红,矿,弓,恭,工,躬,供,公	
再	载,在	灾,仔,栽,宰
冰	兵	屏,丙,病,禀,饼,秉,并,柄
列	猎,烈,裂,劣	咧
刑	形,型,邢,行	兴,幸,猩,星,性,醒,腥,杏,省,姓
划	滑,话,化,桦,猾,华,豁,画,哗	化,花,话,画
劣	猎,列,裂,烈	咧
匈	汹,凶,兄,胸	熊,雄
匠	将,强,降,酱	奖,桨,浆,蒋,僵,疆,姜,江,讲,缰
印	隐,饮	因,姻,音,银,瘾,淫,引,吟,殷,听,蚓,茵,阴
危	薇,唯,违,围,为,微,桅,巍,维	威,委,谓,魏,味,未,喂,遗,畏,伟,尾,胃,位,伪,偎,纬,慰,尉,萎,卫,苇,蔚
吉	极,借,及,吃,脊,唧,即,急,圾,级,寂,集,辑,嫉,击,疾,棘,籍	技,几,箕,其,稽,祭,冀,鸡,际,居,肌,寄,系,剂,继,机,忌,叽,讥,期,季,激,饥,记,济,绩,纪,妓,荠,计,积,既,基,己,鲫,骑,奇,挤,畸,迹,给
吏	利,立,粒,隶,丽,砾,力,痢,莉,厉,例,俐,雳,历,励,沥,荔,栗	哩,李,里,理,厘,璃,离,漓,篱,梨,犁,礼,狸,鲤,黎
同	桐,彤,童,瞳,铜	筒,通,统,痛,桶
吊	调,钓,掉	叼,雕,碉,刁
吐	土,兔	屠,凸,涂,图,途,突,徒,秃
吁	狱,预,语,需,欲,玉,御,愈,虚,豫,喻,须,寓,誉,郁,浴,域,裕,育,尉,谷,芋,与,遇	隅,雨,屿,旭,于,蓄,鱼,予,许,舆,羽,畜,渔,絮,酗,迂,愚,序,淤,徐,宇,叙,愉,绪,婿,续,榆,恤,逾,娱
各	个	格,葛,阁,蛤,戈,搁,胳,鸽,合,隔,疙,割,哥,歌
向	乡,像,相,橡,巷,项,象	响,镶,箱,享,祥,想,降,详,厢,香,湘,翔
名	明,鸣,铭,螟	命
合	盒,格,葛,阁,何,禾,荷,核,和,褐,隔,革,盖,蛤,河	个,哥,喝,呵,戈,搁,吓,胳,鸽,各,赫,疙,割,歌,贺,鹤
吃	吉,极,借,及,脊,急,唧,即,嗤,圾,级,寂,集,辑,嫉,击,疾,棘,籍	技,几,箕,斥,其,稽,祭,冀,鸡,池,际,齿,持,居,肌,寄,驰,系,剂,继,机,忌,叽,讥,期,季,激,饥,记,济,绩,纪,妓,耻,迟,匙,荠,计,积,尺,既,基,己,侈,翅,给,鲫,骑,奇,赤,挤,畸,迹,弛
后	厚,候	喉,吼,猴,侯
吆	邀,么,哟,妖,夭,腰,要	遥,乐,咬,谣,窑,舀,淆,钥,拗,姚,耀,肴,药,摇,侥
因	姻,音,应,殷,茵,阴	隐,银,瘾,淫,引,吟,印,听,蚓,饮
回	蛔,茴	慧,绘,惠,悔,灰,贿,讳,恢,毁,晦,辉,徽,诲,会,溃,汇,秽,挥,虫,堕
地	缔,的,第,蒂,帝,递,弟	涤,嘀,嫡,低,滴,抵,笛,芽,底,敌
在	载,再	灾,仔,栽,宰
多	夺,朵	躲,惰,踱,跺,舵,驮,度,堕
夷	谊,蛇,胰,仪,移,遗,姨,疑,宜,一	掖,已,乙,衣,忆,溢,易,肄,倚,屹,亿,意,艺,议,邑,义,医,绎,揖,毅,矣,亦,译,益,尾,椅,逸,翼,漪,奕,液,役,壹,以,依,艾,伊,蚁,抑,疫,异,腋
夸		跨,垮,胯
妄	忘,望,王,旺	往,汪,枉,亡,网
奸	肩,歼,艰,煎,渐,监,间,溅,坚,兼,尖	箭,见,拣,减,剪,建,捡,件,贱,键,践,鉴,俭,碱,舰,茧,检,简,柬,健,荐,剑,涧
好	镐,耗,浩,号	嚎,壕,豪,毫,鹤,蒿
如	儒,蠕	乳,辱,褥,入,女
字	自	吱,紫,资,滋,籽,滓,姿,仔,子,咨
存		村,寸
宇	羽,雨,屿,语,予,与	狱,隅,预,于,欲,鱼,玉,御,吁,舆,愈,豫,喻,寓,渔,誉,郁,浴,域,裕,迂,愚,淤,育,尉,愉,谷,芋,榆,逾,娱,遇
守	手,首	寿,熟,收,瘦,售,授,受,兽
宅	蔗,这,浙	寨,债,着,斋,摘,遮,窄,哲,祭,齐,折,者,辙,责
安	氨,鞍,庵	按,岸,俺,暗,案
寺	伺,四,肆,赐,饲,食,似	私,撕,思,死,司,丝,斯,嘶
尖	肩,歼,艰,煎,奸,渐,监,间,溅,坚,兼	箭,见,拣,减,剪,建,捡,件,贱,键,践,鉴,俭,碱,舰,茧,检,简,柬,健,荐,剑,涧
屹	掖,衣,忆,溢,肄,易,一,亿,意,艺,邑,义,绎,议,毅,亦,译,益,逸,翼,奕,液,役,谊,艾,腋,抑,疫,异	已,乙,疑,倚,医,揖,夷,移,矣,遗,宜,尾,椅,蛇,漪,姨,壹,以,依,胰,仪,伊,蚁
州	粥,周,舟,洲	轴,帚,宙,咒,肘,昼,皱
帆	矾,凡,烦,樊,番,繁,翻	犯,泛,饭,贩,范,反,返
并	病	屏,丙,冰,禀,饼,秉,柄,兵
年		撵,捻,念,碾
式	恃,适,誓,侍,饰,嗜,士,拭,事,示,室,释,识,市,使,世,势,是,氏,视,柿,逝,试	拾,石,提,失,射,始,虱,十,屎,尸,矢,什,驶,匙,实,史,食,师,硕,湿,蚀,狮,诗,时,施
弛	池,持,迟,驰,匙	吃,嗤,齿,侈,翅,斥,耻,赤,尺
忙	盲,芒,茫,氓	莽
成	澄,呈,橙,惩,承,程,乘,城,盛,诚	撑,逞,秤,称
扣	寇	口
扛	肛,岗,刚,纲,钢,冈,缸	抗,康,港,慷,糠,炕
托	拖,脱	唾,鸵,拓,椭,驮,妥,驼
收		寿,熟,手,首,守,瘦,售,授,受,兽
早	藻,蚤,澡,枣	糟,躁,凿,造,噪,灶,燥,遭,皂
旨	指,止,只,址,纸,趾,征	植,汁,蜘,织,吱,知,直,值,置,芝,滞,治,枝,至,职,秩,殖,帜,只,之,智,致,识,质,挚,窒,脂,稚,氏,执,支,肢,掷,制,志
旬	寻,驯,巡,询,循	逊,讯,训,汛,殉,勋,迅
旭	叙,絮,绪,酗,婿,蓄,续,畜,恤,序	徐,吁,需,须,许,虚
曲	圈,岖,蛆,取,趋,娶,驱,区,躯,屈	去,漆,趣,渠
有	佑,又,幼,右,诱,友	优,由,犹,油,幽,悠,游,忧,尤,邮
朽	宿	休,羞,绣,臭,秀,锈,嗅,修,袖
朴	迫,魄,破,泊,脯,仆,葡,菩,蒲	坡,瀑,浦,普,圃,颇,婆,谱,仆,铺,波,暴,扑,剖,泼
朱	猪,蛛,诸,株,珠	柱,轴,蛀,逐,注,住,煮,驻,主,竹,属,烛,嘱,拄,铸,术,助,祝,贮,筑
朵	躲,多	惰,踱,跺,夺,舵,驮,度,堕
次	伺,厕,刺,赐	词,此,雌,磁,辞,差,慈,祠,瓷
此		词,雌,伺,磁,刺,辞,次,差,赐,厕,慈,祠,瓷
死		私,撕,伺,思,似,四,肆,赐,食,寺,饲,司,丝,斯,嘶
汗	悍,韩,焊,函,汉,翰,憾,旱,撼,含,寒,涵,捍	酣,喊,和,罕
污	屋,呜,于,巫,恶,诬,乌	武,芜,物,误,侮,勿,无,舞,五,吴,坞,梧,务,蜈,雾,晤,鹉,午,亡,捂,悟,伍
江	将,浆,僵,疆,姜,缰	奖,强,桨,酱,蒋,降,匠,讲
池	持,迟,驰,匙,弛	吃,嗤,齿,侈,翅,斥,耻,赤,尺
汛	讯,训,驯,殉,逊,迅	寻,旬,巡,询,循,勋
灰	恢,辉,徽,挥,堕	慧,绘,惠,悔,贿,讳,汇,毁,晦,茴,诲,会,溃,蛔,秽,虫,回
百	摆	拜,败,白
竹	轴,逐,烛,术,筑	柱,蛀,注,住,煮,蛛,驻,主,珠,诸,属,嘱,拄,朱,铸,株,助,猪,祝,贮
米	靡	蜜,咪,谜,泌,弥,糜,迷,密,觅,秘
羊	杨,扬,阳,洋	养,央,氧,样,鸯,漾,仰,殃,秧,痒
羽	宇,雨,屿,语,予,与	狱,隅,预,于,欲,鱼,玉,御,吁,舆,愈,豫,喻,寓,渔,誉,郁,浴,域,裕,迂,愚,淤,育,尉,愉,谷,芋,榆,逾,娱,遇
老	姥	烙,络,牢,捞,唠,劳,酪
考	拷,烤	铐,靠
而	儿	贰,耳,二,尔,饵
耳	尔,儿,饵	贰,而,儿,二
肉		蹂,柔,揉
肋	勒,乐,垃	了
肌	期,唧,激,饥,几,绩,箕,居,讥,其,稽,奇,机,畸,积,鸡,迹,叽,基	吉,吃,技,即,圾,集,祭,冀,嫉,籍,借,脊,际,级,寂,寄,系,剂,继,忌,击,极,季,记,济,纪,妓,辑,计,疾,既,及,己,急,给,鲫,骑,挤,棘,荠
臣	陈,尘,忱,晨,沈,沉,辰	趁,称,衬
自	字	吱,紫,资,滋,籽,滓,姿,仔,子,咨
至	质,知,挚,秩,制,帜,志,窒,智,治,置,滞,稚,致,识	植,汁,蜘,织,吱,旨,直,值,芝,枝,职,殖,只,之,趾,指,止,纸,脂,氏,执,支,肢,掷,址,征
臼	旧,救,疚,舅,究,就	酒,韭,鸠,久,灸,九,揪,玖,纠
舌	什,蛇,甚	社,拾,叶,设,舍,射,涉,奢,赊,摄,赦
舟	粥,周,洲,州	轴,帚,宙,咒,肘,昼,皱
色	圾,涩,瑟,塞	
艾	掖,衣,忆,溢,碍,易,肄,屹,一,亿,意,艺,议,邑,义,隘,绎,毅,亦,译,益,逸,翼,奕,爱,液,役,谊,腋,抑,疫,异	已,乙,埃,唉,疑,倚,矮,医,揖,夷,移,矣,遗,哀,蔼,宜,尾,椅,蛇,漪,姨,壹,以,依,胰,挨,仪,哎,伊,蚁
虫	悔,毁,崇,重,诲,会,贿	慧,绘,堕,惠,灰,讳,恢,汇,晦,充,辉,茴,宠,徽,溃,蛔,冲,秽,挥,回
血	雪,穴,削,写	泻,薛,楔,学,解,骇,谐,卸,谢,些,携,协,靴,斜,蟹,械,胁,屑,歇,邪,屉,懈,鞋,挟,契
行	希,吸,邢,型,溪,稀,牺,膝,熙,犀,携,西,悉,晰,栖,形,嬉,蟋,吭,刑,厘,析,航,杭,畦	息,星,习,腥,幸,席,猩,锡,醒,隙,系,媳,戏,洗,熄,兴,性,喜,惜,昔,细,夕,徙,杏,袭,省,姓
衣	掖,忆,溢,易,肄,屹,一,亿,意,艺,议,邑,义,医,绎,揖,毅,亦,译,益,逸,翼,漪,奕,液,役,壹,依,谊,艾,伊,抑,疫,异,腋	椅,蛇,胰,已,乙,仪,夷,移,蚁,尾,矣,遗,姨,疑,倚,宜,以
西	悉,希,晰,溪,厘,析,稀,栖,牺,嬉,膝,熙,犀,吸,蟋,行,携,畦	席,息,习,昔,锡,喜,惜,细,夕,隙,系,徙,熄,媳,袭,洗,戏
串		喘,穿,川,船,传
位	慰,胃,魏,尉,味,未,卫,喂,为,遗,谓,蔚,伪,畏	危,薇,萎,威,唯,苇,违,委,偎,围,微,伟,桅,巍,维,纬,尾
住	柱,蛀,注,驻,铸,助,祝	轴,逐,猪,煮,蛛,主,竹,诸,属,烛,嘱,朱,拄,株,术,珠,贮,筑
伴	办,拌,半,瓣,绊,扮	版,班,板,扳,颁,搬,般,斑
何	盒,禾,核,荷,合,褐,盖,和,河	喝,呵,吓,赫,贺,鹤
估	雇,沽,告,故,咕,固,顾,家,姑,孤,辜	滑,凸,古,谷,骨,股,鼓,贾
佑	又,幼,右,诱,有	优,由,犹,油,幽,悠,游,忧,尤,邮,友
伺	刺,肆,四,次,赐,厕,食,饲,寺,似	私,撕,词,此,雌,磁,思,辞,差,慈,死,司,丝,斯,祠,瓷,嘶
伸	绅,身,深,信,呻,参,申	肾,神,渗,审,沈,婶,甚,慎
佃	惦,淀,殿,电,店,垫,奠,玷,甸	颠,碘,典,点
似	伺,四,肆,赐,食,饲,寺	私,撕,思,死,司,丝,斯,嘶
但	石,淡,蛋,旦,诞,担,弹,氮	丹,耽,胆,单
佣	庸,拥,用	庸,咏,踊,蛹,用,泳,勇,永,拥
作	坐,座,凿,做,昨	左
伯	爸,舶,驳,膊,白,搏,坝,耙,脖,泊,渤,罢,荸,卜,霸,柏,勃,博,薄	芭,播,靶,叭,把,跛,吧,般,菠,捌,笆,巴,八,疤,跋,簸,扒,拨,剥,玻,拔
低	滴	涤,嘀,嫡,敌,缔,抵,蒂,笛,的,第,帝,地,芽,递,底,弟
伶	铃,凌,玲,龄,零,菱,陵,翎,蛉,灵	另,岭,领,令
兑	对,队	堆
克	可,课,刻,客	坷,颗,壳,棵,科,磕,咳,苛,渴,蝌
免	紊,问,冕,文,闻,勉,缅,娩	纹,瘟,绵,蚊,温,吻,面,棉,稳,眠
兵	冰	屏,丙,病,禀,饼,秉,并,柄
冶	野,也	业,叶,谒,爷,咽,夜,射,页,椰
冷		楞
别		鳖,瘪
判	叛,畔,盼	盘,潘,般,胖,攀
利	立,粒,隶,丽,砾,力,痢,莉,厉,例,俐,雳,吏,历,励,沥,荔,栗	哩,李,里,理,厘,璃,离,漓,篱,梨,犁,礼,狸,鲤,黎
删	山,衫,扇,珊,杉	善,赡,陕,膳,擅,闪,单
刨	暴,爆,袍,豹,咆,炮,抱,报	胞,抛,跑,保,褒,雹,苞,宝,泡,饱,包,堡,薄
劫	结,洁,捷,截,竭,杰,节	借,界,街,诫,揭,皆,阶,解,介,芥,接,姊,届,戒,姐
助	柱,蛀,注,住,驻,铸,祝	轴,逐,猪,煮,蛛,主,竹,诸,属,烛,嘱,朱,拄,株,术,珠,贮,筑
努		奴,怒
匣	侠,辖,暇,斜,狭,挟,峡,霞,洽	下,夏,虾,吓,厦,瞎
即	吉,极,借,及,吃,脊,唧,急,圾,级,寂,集,辑,嫉,击,疾,棘,籍	技,几,箕,其,稽,祭,冀,鸡,际,居,肌,寄,系,剂,继,机,忌,叽,讥,期,季,激,饥,记,济,绩,纪,妓,荠,计,积,既,基,己,鲫,骑,奇,挤,畸,迹,给
卵		乱,峦
吝	赁,躏	淋,磷,邻,琳,凛,鳞,林,临
吭	行,杭,航,坑	
吞		褪,囤,臀,屯
否	匹	坏,霹,疲,譬,罢,脾,皮,僻,啤,批,辟,屁,劈,被,披
吧	捌,芭,笆,扒,巴,罢,叭,八,疤	爸,坝,耙,靶,霸,跋,伯,拔,把
呆	待	带,逮,歹,大,代,怠,贷,袋,戴
吴	无,梧,巫,亡,蜈,诬,芜	屋,武,于,物,误,污,侮,勿,呜,舞,五,乌,坞,务,雾,晤,鹉,午,捂,恶,悟,伍
呈	澄,橙,惩,承,成,程,乘,城,盛,诚	撑,逞,秤,称
吕	缕,旅,铝,侣,娄,履,屡	虑,滤,率,绿,氯,驴,律
君	龟,均,钧,军	俊,窘,峻,骏,竣,菌
吩	芬,纷,分,氛	份,忿,奋,粪,粉,愤,焚,坟
告	雇,固,故,估,顾	古,稿,篙,膏,滑,搞,咕,股,姑,贾,辜,高,凸,沽,孤,家,糕,搅,谷,骨,鼓,羔
吹	炊	锤,垂,捶,椎
吻	稳	紊,纹,问,瘟,文,蚊,免,闻,温
吸	西,悉,希,晰,溪,厘,析,稀,栖,牺,嬉,膝,熙,犀,携,蟋,行,畦	席,息,习,昔,锡,喜,惜,细,夕,隙,系,徙,熄,媳,袭,洗,戏
吮	盾	瞬,顺
吵	炒	钞,巢,朝,抄,超,剿,潮,嘲
呐	那,娜,钠,捺,纳	拿,哪
吠	肺,费,沸,废	飞,匪,啡,菲,诽,肥,非
吼		喉,猴,候,后,厚,侯
呀	鸦,押,压,鸭	哑,衙,雅,讶,轧,涯,蚜,牙,芽,亚
吱	汁,蜘,织,氏,支,资,知,肢,只,滋,之,姿,芝,枝,咨,脂	植,旨,自,直,值,置,滞,治,至,字,职,秩,殖,帜,智,趾,致,识,指,质,止,挚,窒,籽,纸,稚,子,紫,执,掷,址,制,志,滓,征,仔
含	韩,函,汗,寒,涵	悍,喊,罕,焊,汉,翰,憾,酣,旱,撼,和,捍
吟	淫,银	因,隐,姻,音,瘾,引,殷,印,听,蚓,茵,阴,饮
听	隐,厅,瘾,引,蚓,饮	因,亭,姻,蜓,银,音,庭,淫,吟,挺,殷,印,艇,茵,阴,停,廷
囱	从,匆,窗,聪,葱,创,疮	撞,抢,床,丛,闯,幢
困		捆,昆,坤
囤	盾,顿,吨,钝,盹,屯,臀	蹲,吞,墩,褪,敦
坊	妨,房,防,芳,方,肪	放,纺,仿,访
坑	吭	
址	指,止,旨,只,纸,趾,征	植,汁,蜘,织,吱,知,直,值,置,芝,滞,治,枝,至,职,秩,殖,帜,只,之,智,致,识,质,挚,窒,脂,稚,氏,执,支,肢,掷,制,志
均	君,龟,军,钧	俊,窘,峻,骏,竣,菌
坎	砍	看,勘,堪,刊
圾	吉,吃,即,集,嫉,籍,色,借,脊,级,寂,击,塞,极,涩,唧,辑,疾,瑟,及,急,棘	技,几,箕,其,稽,祭,冀,鸡,际,居,肌,寄,系,剂,继,机,忌,叽,讥,期,季,激,饥,记,济,绩,纪,妓,荠,计,积,既,基,己,鲫,骑,奇,挤,畸,迹,给
坐	作,做,座,凿	昨,左
坏	霹,胚,批,劈,被,匹,披	疲,配,否,譬,脾,淮,赔,啤,皮,陪,怀,培,罢,辟,僻,徊,佩,槐,沛,屁
壮	状,撞	妆,装,桩,庄
夹	佳,茄,挟,嘉,加,荚,家,颊	夏,稼,价,假,驾,架,甲,钾,嫁,贾
妆	装,桩,庄	状,撞,壮
妒	肚,渡,度,镀,杜	睹,牍,读,毒,督,都,赌,独,堵
妨	坊,房,肪,防	纺,仿,访,方,芳,放
妙	庙	瞄,渺,秒,苗,藐,描
妖	邀,么,哟,吆,夭,腰,要	遥,乐,咬,谣,窑,舀,淆,钥,拗,姚,耀,肴,药,摇,侥
妓	计,技,季,际,记,济,纪,寄,系,鲫,剂,骑,继,忌,祭,冀,既,荠	吉,吃,即,几,圾,箕,其,稽,集,嫉,鸡,籍,借,脊,级,居,寂,肌,机,叽,击,讥,极,期,唧,激,饥,绩,辑,积,疾,基,及,己,急,奇,挤,畸,棘,迹,给
妥	椭	拖,托,唾,鸵,脱,拓,驮,驼
孝	啸,酵,校,效,肖,笑	哮,小,销,萧,嚣,削,硝,宵,箫,学,消,晓
完	顽,玩,丸	弯,宛,挽,婉,碗,惋,万,腕,湾,晚,豌,娩
宋	送,讼,诵,颂	松,耸
宏	虹,红,洪,鸿	轰,烘,哄,汞
局	菊,橘,鞠	拒,足,聚,举,剧,炬,沮,居,锯,句,巨,具,拘,惧,矩,蛆,俱,据,车,驹,距
屁	譬,僻,辟	坏,霹,疲,否,脾,啤,批,罢,皮,劈,被,匹,披
尿		鸟
尾	椅,已,乙,萎,苇,委,蚁,矣,伟,倚,纬,以	掖,衣,威,忆,溢,谓,易,肄,疑,屹,巍,亿,一,议,意,邑,艺,魏,绎,义,医,味,揖,未,毅,夷,移,围,喂,遗,亦,译,宜,畏,益,蛇,胃,薇,逸,位,翼,漪,为,奕,微,姨,液,维,役,伪,壹,桅,胰,偎,慰,谊,依,艾,仪,尉,唯,卫,违,伊,抑,疫,异,腋,蔚,危
岔	刹,差	插,叉,茶,喳,查,察
巫	污,屋,呜,于,无,梧,亡,蜈,恶,吴,诬,芜,乌	晤,误,悟,坞,侮,武,勿,鹉,舞,午,五,捂,务,物,雾,伍
希	西,悉,溪,晰,厘,析,稀,栖,牺,嬉,膝,熙,犀,吸,蟋,行,携,畦	席,息,习,昔,锡,喜,惜,细,夕,隙,系,徙,熄,媳,袭,洗,戏
序	叙,絮,旭,绪,酗,婿,蓄,续,畜,恤	徐,吁,需,须,许,虚
庇	闭,币,毙,蔽,碧,毕,泌,避,璧,比,壁,弊,臂,辟,鄙,必	笔,彼,逼,匕,鼻
床	幢,撞	囱,抢,窗,闯,创,疮
廷	亭,停,蜓,庭	听,厅,挺,艇
弄		农,浓,脓
弟	缔,的,第,蒂,帝,地,递	涤,嘀,嫡,低,滴,抵,笛,芽,底,敌
彤	桐,童,瞳,同,铜	筒,通,统,痛,桶
形	型,刑,邢,行	兴,幸,猩,星,性,醒,腥,杏,省,姓
役	掖,衣,忆,溢,肄,易,屹,一,亿,意,艺,邑,义,绎,议,毅,亦,译,益,逸,翼,奕,液,谊,艾,腋,抑,疫,异	已,乙,疑,倚,医,揖,夷,移,矣,遗,宜,尾,椅,蛇,漪,姨,壹,以,依,胰,仪,伊,蚁
忘	望,王,妄,旺	往,汪,枉,亡,网
忌	计,技,季,际,记,济,妓,纪,寄,系,鲫,剂,骑,继,祭,冀,既,荠	吉,吃,即,几,圾,箕,其,稽,集,嫉,鸡,籍,借,脊,级,居,寂,肌,机,叽,击,讥,极,期,唧,激,饥,绩,辑,积,疾,基,及,己,急,奇,挤,畸,棘,迹,给
志	质,知,挚,识,窒,秩,制,帜,智,治,置,滞,稚,致,至	植,汁,蜘,织,吱,旨,直,值,芝,枝,职,殖,只,之,趾,指,止,纸,脂,氏,执,支,肢,掷,址,征
忍		刃,韧,纫,任,人,仁,认,儿,赁
忱	陈,尘,晨,沈,臣,沉,辰	趁,称,衬
快	刽,筷,会,块	
戒	借,界,诫,介,芥,届,解	街,结,揭,皆,阶,洁,杰,劫,捷,截,竭,接,姊,节,姐
抄	超,剿,钞	炒,朝,吵,巢,潮,嘲
抗	炕	慷,扛,康,糠
抖	蚪,斗,陡	兜,豆,读,逗,都,痘,斗
技	计,季,际,记,济,妓,纪,寄,系,鲫,剂,骑,继,忌,祭,冀,既,荠	吉,吃,即,几,圾,箕,其,稽,集,嫉,鸡,籍,借,脊,级,居,寂,肌,机,叽,击,讥,极,期,唧,激,饥,绩,辑,积,疾,基,及,己,急,奇,挤,畸,棘,迹,给
扶	袱,幅,拂,福,辐,俘,符,浮,蝠,缚,服,夫,伏,芙	甫,复,麸,负,咐,腹,妇,辅,孵,父,肤,赋,附,付,抚,斧,赴,腐,脯,府,俯,敷,富,傅,副
扭	钮,纽	牛,拗
把	靶	爸,捌,芭,笆,扒,坝,耙,拔,巴,罢,叭,八,疤,霸,跋,伯,吧
扼	噩,哑,遏,俄,恶,饿,愕,鳄	讹,鹅,额,蛾,阿
找	沼,爪	罩,招,着,朝,昭,赵,照,兆,召,嘲
批	坏,霹,劈,被,匹,披	疲,譬,否,罢,啤,脾,皮,僻,辟,屁
扳	班,颁,搬,般,斑	版,伴,办,板,拌,半,瓣,绊,扮
抒	枢,梳,书,舒,蔬,殊,输,疏	鼠,蜀,树,赎,述,暑,束,恕,黍,薯,竖,曙,淑,属,墅,术,庶,漱,数,熟,叔,署
扯		彻,撤,澈,车,辙
折	辙,哲,摘	着,宅,浙,遮,蔗,者
扮	伴,办,拌,半,瓣,绊	版,班,板,扳,颁,搬,般,斑
投	头	偷,透
抓		爪
抑	掖,衣,忆,溢,肄,易,屹,一,亿,意,艺,邑,义,绎,议,毅,亦,译,益,逸,翼,奕,液,役,谊,艾,腋,疫,异	已,乙,疑,倚,医,揖,夷,移,矣,遗,宜,尾,椅,蛇,漪,姨,壹,以,依,胰,仪,伊,蚁
改		丐,该,钙,盖,概,溉
攻	蚣,功,宫,共,红,弓,恭,工,躬,供,公	贡,巩,汞,矿,拱
旱	悍,焊,汉,翰,憾,撼,汗,捍	韩,喊,罕,函,酣,含,寒,和,涵
更	精,京,兢,晶,羹,鲸,耕,睛,荆,惊,经,茎	径,梗,埂,耿,境,竞,静,劲,净,警,靖,颈,敬,阱,景,镜,井,竟
束	述,竖,漱,数,曙,恕,署,树,墅,术,庶,疏	鼠,薯,抒,枢,熟,蜀,梳,暑,书,叔,淑,属,舒,蔬,赎,殊,输,黍
李	哩,里,理,礼,鲤	立,砾,璃,痢,俐,狸,沥,隶,离,犁,励,粒,丽,厉,梨,雳,篱,历,荔,栗,利,力,厘,莉,漓,例,吏,黎
杏	兴,幸,性,姓	型,刑,星,猩,醒,形,省,腥,行,邢
材	才,财,裁	彩,踩,睬,猜,菜,采
村		存,寸
杜	妒,肚,渡,度,镀	睹,牍,读,毒,督,都,赌,独,堵
杖	胀,丈,长,涨,障,帐,仗,账	樟,掌,张,彰,章
杉	删,沙,煞,山,衫,杀,扇,珊,砂,纱	善,霎,赡,陕,傻,擅,闪,膳,厦,单
杆	柑,敢,竿,甘,赶,肝,橄,秆,感,干	柑,敢,竿,甘,赶,肝,橄,秆,感,干
步	埠,怖,部,不,布,簿	补,捕,卜,哺
每	美	媚,眉,霉,梅,媒,楣,没,枚,昧,煤,妹,玫
求	囚,仇,球	丘,秋,龟,蚯
汞	拱,共,巩,矿	贡,蚣,宫,功,哄,鸿,烘,攻,宏,红,虹,洪,轰,弓,恭,工,躬,供,公
沙	煞,杀,砂,纱,杉	厦,霎,傻
沈	陈,晨,忱,尘,审,婶,臣,沉,辰	肾,身,绅,神,深,呻,信,渗,伸,称,衬,趁,参,申,甚,慎
沉	陈,尘,忱,晨,沈,臣,辰	趁,称,衬
沛	佩,配	坏,胚,培,赔,陪
汪		往,忘,旺,妄,枉,亡,望,王,网
决	诀,倔,觉,掘,嚼,角,绝,脚,爵	
沐	牧,幕,募,慕,睦,穆,暮,目,墓,木	姥,拇,牡,模,母,姆,亩
汰	态,泰,太	台,抬,胎,苔
冲	充	崇,宠,重,虫
没	眉,墨,玫,霉,梅,默,末,寞,莫,沫,磨,茉,媒,楣,膜,枚,煤,漠,脉,陌	媚,么,蘑,摸,摹,每,魔,美,昧,摩,抹,模,妹
汽	弃,气,妻,砌,迄,契,器,泣,企	启,起,鳍,稽,柒,其,崎,枝,戚,溪,旗,脐,只,欺,祈,期,漆,乞,栖,歧,七,凄,棋,骑,奇,畦,岂,齐
沃	握,卧	涡,窝,我
灶	躁,造,噪,燥,皂	糟,凿,蚤,枣,早,藻,澡,遭
灼	茁,啄,酌,琢,着,卓,浊,拙	桌,捉
灾	栽	宰,再,载,仔,在
灸	酒,韭,久,九,玖,纠	旧,救,疚,鸠,臼,舅,究,就,揪
牢	唠,劳	姥,烙,络,老,捞,酪
牡	姥,拇,母,姆,亩	沐,牧,幕,募,慕,睦,穆,暮,模,目,墓,木
狂		筐,况,眶,矿,旷,框
玖	酒,韭,久,灸,九,纠	旧,救,疚,鸠,臼,舅,究,就,揪
甫	父,抚,斧,脯,府,俯,辅,腐	辐,符,麸,负,咐,复,副,缚,腹,服,扶,妇,夫,孵,肤,赋,福,俘,附,浮,蝠,付,幅,赴,芙,袱,拂,敷,富,傅,伏
男	难,南	
甸	惦,佃,淀,殿,电,店,垫,奠,玷	颠,碘,典,点
皂	躁,造,噪,灶,燥	糟,凿,蚤,枣,早,藻,澡,遭
盯	钉,叮,丁	定,订,鼎,锭,顶
矣	椅,已,乙,蚁,倚,以,尾	掖,衣,忆,溢,易,肄,疑,屹,一,亿,意,艺,议,邑,义,医,绎,揖,毅,夷,移,遗,亦,译,宜,益,蛇,逸,翼,漪,奕,姨,液,役,壹,依,谊,胰,艾,仪,伊,抑,疫,异,腋
私	撕,思,司,丝,斯,嘶	伺,肆,四,赐,食,饲,死,寺,似
秀	绣,臭,宿,锈,嗅,袖	休,羞,修,朽
秃		屠,凸,涂,兔,土,图,途,吐,突,徒
究	旧,救,疚,臼,舅,就	酒,韭,鸠,久,灸,九,揪,玖,纠
系	技,祭,冀,际,寄,隙,剂,继,忌,戏,季,记,济,妓,纪,计,既,细,夕,鲫,骑,荠	吉,息,希,吃,习,即,几,圾,箕,其,集,稽,吸,行,嫉,鸡,籍,借,席,溪,脊,锡,稀,级,寂,肌,居,牺,膝,熙,犀,机,携,媳,叽,击,洗,熄,讥,极,西,悉,期,晰,唧,激,饥,喜,惜,栖,绩,嬉,辑,蟋,积,疾,基,及,己,急,厘,析,昔,徙,奇,挤,畦,畸,袭,棘,迹,给
罕	喊	悍,韩,焊,函,汉,翰,憾,酣,旱,撼,含,汗,寒,和,涵,捍
肖	啸,酵,校,孝,效,笑	哮,小,销,萧,嚣,削,硝,宵,箫,学,消,晓
肝	柑,杆,竿,甘,干	敢,杆,赶,感,秆,橄,干
肘	帚	轴,洲,州,周,舟,宙,咒,粥,昼,皱
肛	岗,刚,纲,钢,冈,扛,缸	港
肚	睹,妒,渡,赌,度,镀,杜,堵	牍,读,毒,督,都,独
育	狱,预,语,欲,玉,御,愈,吁,豫,喻,寓,誉,郁,浴,域,裕,尉,谷,芋,与,遇	隅,羽,雨,屿,宇,愉,于,迂,鱼,愚,予,榆,逾,淤,渔,娱,舆
良	粮,凉,粱,量,梁	晾,俩,两,亮,谅,辆
芒	盲,茫,忙,氓	莽
芋	狱,预,语,欲,玉,御,愈,吁,豫,喻,寓,誉,郁,浴,域,裕,育,尉,谷,与,遇	隅,羽,雨,屿,宇,愉,于,迂,鱼,愚,予,榆,逾,淤,渔,娱,舆
芍	勺	梢,哨,烧,少,绍,稍,捎,召
见	舰,健,箭,荐,剑,溅,件,贱,渐,键,监,践,间,建,涧,鉴	碱,肩,俭,茧,歼,艰,煎,奸,拣,减,剪,检,简,坚,兼,捡,尖,柬
角	诀,倔,搅,缴,觉,狡,掘,嚼,矫,绝,决,侥,脚,剿,较,饺,爵,绞	蕉,窖,教,焦,叫,椒,骄,交,校,郊,礁,浇,轿,胶,娇
言	延,癌,阎,严,研,沿,颜,盐,炎	燕,掩,眼,衍,验,烟,咽,焰,奄,艳,殷,演,厌,谚,雁,砚,淹,堰,唁,宴
谷	狱,古,预,语,欲,玉,御,吁,愈,滑,豫,喻,寓,股,贾,誉,郁,凸,浴,域,裕,育,尉,骨,芋,鼓,与,遇	隅,屿,雨,于,估,鱼,予,舆,羽,咕,渔,姑,辜,雇,沽,故,顾,迂,愚,淤,孤,家,宇,告,愉,固,榆,逾,娱
豆	逗,斗,读,痘	蚪,兜,抖,陡,都,斗
贝	辈,备,狈,背,惫,焙,臂,倍,被	北,杯,卑,碑,悲
赤	翅,斥	吃,池,嗤,持,齿,侈,耻,迟,驰,匙,尺,弛
走		骤,奏,揍
足	拒,族,惧,炬,俱,据,具,聚,锯,句,巨,卒,距,剧	祖,组,菊,驹,蛆,沮,居,阻,橘,诅,车,鞠,举,局,矩,租,拘
身	圈,绅,深,鹃,信,呻,生,伸,参,捐,申	肾,绢,神,卷,眷,渗,沈,审,婶,倦,甚,慎
车	蛆,俱,沮,居,锯,驹,拘	足,拒,聚,举,剧,炬,句,巨,具,惧,扯,局,撤,澈,辙,矩,菊,据,橘,鞠,彻,距
辛	幸,芯,薪,新,心,锌,欣	衅,信,寻
辰	陈,尘,忱,晨,沈,臣,沉	趁,称,衬
迂	淤	狱,隅,雨,屿,预,语,于,欲,鱼,予,玉,御,吁,舆,愈,豫,羽,喻,寓,渔,誉,郁,浴,域,裕,愚,育,宇,尉,愉,谷,芋,榆,逾,与,娱,遇
迅	讯,训,驯,汛,殉,逊	寻,旬,巡,询,循,勋
迄	弃,气,妻,砌,汽,契,器,泣,企	启,起,鳍,稽,柒,其,崎,枝,戚,溪,旗,脐,只,欺,祈,期,漆,乞,栖,歧,七,凄,棋,骑,奇,畦,岂,齐
巡	寻,驯,旬,询,循	逊,讯,训,汛,殉,勋,迅
邑	掖,衣,忆,溢,肄,易,屹,一,亿,意,艺,绎,义,议,毅,亦,译,益,逸,翼,奕,液,役,谊,艾,腋,抑,疫,异	已,乙,疑,倚,医,揖,夷,移,矣,遗,宜,尾,椅,蛇,漪,姨,壹,以,依,胰,仪,伊,蚁
邢	形,刑,型,行	兴,幸,猩,星,性,醒,腥,杏,省,姓
邪	谐,协,斜,鞋,胁,挟,携	泻,卸,懈,屉,械,蟹,谢,楔,些,屑,写,血,契,骇,歇,解
邦	梆,帮,傍	膀,蚌,磅,榜,棒,旁,绑,谤
那	娜,钠,捺,哪,纳,呐	拿
里	哩,李,理,礼,鲤	立,砾,璃,痢,俐,狸,沥,隶,离,犁,励,粒,丽,厉,梨,雳,篱,历,荔,栗,利,力,厘,莉,漓,例,吏,黎
防	坊,房,肪,妨	纺,仿,访,方,芳,放
阱	警,颈,景,井	兢,静,晶,鲸,靖,惊,竟,精,境,更,睛,茎,径,京,劲,敬,荆,竞,净,镜,经
乖		怪,拐
乳	辱,女	儒,蠕,如,褥,入
事	恃,适,誓,侍,饰,嗜,士,式,拭,示,室,释,识,市,使,世,势,是,氏,视,柿,逝,试	拾,石,提,失,射,始,虱,十,屎,尸,矢,什,驶,匙,实,史,食,师,硕,湿,蚀,狮,诗,时,施
些	歇	泻,楔,写,骇,解,谐,卸,谢,携,协,斜,械,蟹,胁,屑,邪,屉,懈,鞋,血,挟,契
亚	雅,讶,哑,轧	押,压,衙,涯,呀,鸦,蚜,牙,芽,鸭
享	想,响	向,镶,箱,乡,祥,降,详,相,厢,像,巷,橡,香,湘,项,象,翔
京	精,兢,晶,鲸,更,睛,荆,惊,经,茎	径,境,竞,静,劲,净,警,靖,颈,阱,景,敬,镜,井,竟
依	医,揖,衣,漪,伊,壹,一	掖,已,乙,忆,溢,易,肄,疑,倚,屹,亿,意,艺,议,邑,义,绎,毅,夷,移,矣,遗,亦,译,宜,益,尾,椅,蛇,逸,翼,奕,姨,液,役,以,谊,胰,艾,仪,蚁,抑,疫,异,腋
侍	恃,适,誓,饰,嗜,士,式,拭,事,示,室,释,识,市,使,世,势,是,氏,视,柿,逝,试	拾,石,提,失,射,始,虱,十,屎,尸,矢,什,驶,匙,实,史,食,师,硕,湿,蚀,狮,诗,时,施
佳	夹,茄,嘉,加,家	夏,稼,价,假,驾,架,甲,挟,钾,嫁,荚,贾,颊
使	恃,适,誓,侍,始,饰,嗜,士,式,拭,屎,事,示,室,释,识,市,矢,世,驶,势,史,是,氏,视,柿,逝,试	拾,施,石,失,提,什,射,蚀,尸,匙,虱,狮,实,诗,硕,食,师,时,十,湿
供	蚣,贡,功,宫,共,攻,红,弓,恭,工,躬,公	巩,矿,拱,汞
例	利,立,粒,隶,丽,砾,力,痢,莉,厉,俐,雳,吏,历,励,沥,荔,栗	哩,李,里,理,厘,璃,离,漓,篱,梨,犁,礼,狸,鲤,黎
来	莱	赖,癞
侈	齿,尺,耻	吃,池,嗤,持,翅,迟,驰,斥,匙,赤,弛
佩	配,沛	坏,胚,培,赔,陪
仑	论,轮,沦,抡,伦	
兔	吐	屠,凸,涂,土,图,途,突,徒,秃
两	俩	晾,粮,良,凉,粱,亮,量,谅,辆,梁
具	拒,足,惧,炬,俱,据,聚,锯,句,巨,距,剧	菊,蛆,沮,居,橘,车,鞠,矩,举,局,驹,拘
其	几,箕,崎,鳍,稽,鸡,枝,旗,居,肌,脐,只,机,叽,讥,祈,期,唧,激,饥,绩,歧,积,基,棋,骑,奇,畦,畸,迹,齐	吉,吃,技,气,即,圾,启,起,柒,集,祭,冀,嫉,戚,籍,借,弃,脊,溪,际,级,寂,寄,系,剂,迄,继,忌,器,泣,击,欺,极,季,漆,记,砌,纪,妓,济,栖,乞,辑,荠,计,七,疾,既,及,己,急,凄,妻,给,鲫,挤,契,汽,岂,棘,企
典	碘,点	颠,惦,佃,淀,殿,电,店,垫,奠,玷,甸
函	韩,含,汗,寒,涵	悍,喊,罕,焊,汉,翰,憾,酣,旱,撼,和,捍
刻	颗,克,棵,科,磕,可,课,客,苛,蝌	渴,咳,坷,壳
券	劝	圈,卷,全,权,拳,痊,泉,犬
刷		耍
刺	伺,厕,次,赐	词,此,雌,磁,辞,差,慈,祠,瓷
到	蹈,导,盗,悼,倒,道,稻	祷,岛,叨,捣,刀
刮	蜗,括,瓜	褂,挂,卦,寡
制	质,知,挚,识,窒,秩,志,帜,智,治,置,滞,稚,致,至	植,汁,蜘,织,吱,旨,直,值,芝,枝,职,殖,只,之,趾,指,止,纸,脂,氏,执,支,肢,掷,址,征
卒	族,足,促,趋,醋,错,趣,簇	组,阻,诅,粗,租,祖
协	谐,邪,斜,鞋,胁,挟,携	泻,卸,懈,屉,械,蟹,谢,楔,些,屑,写,血,契,骇,歇,解
卓	茁,啄,酌,琢,着,灼,浊,拙	桌,捉
卑	碑,背,悲,杯	辈,北,备,贝,狈,惫,焙,臂,倍,被
卦	褂,挂	括,瓜,刮,寡,蜗
卷	圈,绢,眷,全,权,拳,痊,泉,犬,倦	身,鹃,券,捐,劝
卸	泻,懈,屉,蟹,谢,械,楔,屑,契,骇,解	谐,协,邪,斜,些,鞋,血,胁,写,挟,携,歇
取	曲,娶	圈,岖,蛆,趋,漆,渠,趣,驱,区,去,躯,屈
叔	熟,赎,淑	鼠,蜀,树,述,梳,暑,束,恕,蔬,输,黍,疏,薯,竖,抒,书,曙,属,墅,术,庶,枢,漱,数,署,舒,殊
受	寿,瘦,售,授,兽	熟,手,首,守,收
味	慰,胃,魏,尉,未,卫,位,喂,为,遗,谓,蔚,伪,畏	危,薇,萎,威,唯,苇,违,委,偎,围,微,伟,桅,巍,维,纬,尾
呵	喝	盒,何,禾,核,荷,吓,合,鹤,赫,褐,盖,和,贺,河
咖	哈	咳,卡
咕	沽,估,家,姑,孤,辜	滑,雇,凸,古,告,固,故,谷,骨,顾,股,鼓,贾
呻	绅,身,深,信,伸,参,申	肾,神,渗,审,沈,婶,甚,慎
咒	昼,皱,宙	轴,洲,州,周,舟,帚,肘,粥
咆	袍,炮,刨	抛,跑,泡
呼	戏,乎,忽	糊,壶,胡,护,蝴,唬,葫,沪,虎,互,湖,狐,许,户,弧
咐	父,赋,复,附,负,副,赴,富,妇,傅,腹,付	甫,辐,符,麸,缚,服,扶,辅,夫,孵,肤,福,俘,浮,蝠,抚,幅,斧,腐,芙,袱,拂,脯,府,俯,敷,伏
和	盒,喝,何,荷,核,禾,吓,合,酣,鹤,赫,褐,盖,贺,河	罕,呵,函,汉,伙,撼,汗,涵,豁,憾,获,捍,喊,焊,旱,货,寒,悍,韩,活,霍,翰,惑,祸,含,火,或
呢	泥,尼	你,匿,腻,拟,溺,逆
周	粥,洲,州,舟	轴,帚,宙,咒,肘,昼,皱
命		螟,明,名,鸣,铭
固	雇,告,故,估,顾	滑,凸,古,沽,咕,谷,骨,孤,股,鼓,姑,家,贾,辜
垃	勒,肋,乐	了
坷	可,渴	刻,颗,壳,克,棵,科,磕,咳,课,客,苛,蝌
坪	屏,冯,凭,苹,平,评,萍,瓶	乒
坡	泼,波	迫,魄,破,颇,泊,婆,朴,剖
坦	袒,毯	谈,叹,碳,瘫,昙,潭,滩,贪,谭,痰,坛,摊,弹,檀,探,炭
坤	昆	捆,困
夜	叶,谒,咽,射,页,业	爷,冶,野,也,椰
奉	凤,讽,缝	冯,疯,枫,峰,风,蜂,封,丰,逢,锋
奇	几,箕,崎,鳍,稽,其,鸡,枝,旗,居,肌,脐,只,机,叽,讥,祈,期,唧,激,饥,绩,歧,积,基,棋,骑,畦,畸,迹,齐	吉,吃,技,气,即,圾,启,起,柒,集,祭,冀,嫉,戚,籍,借,弃,脊,溪,际,级,寂,寄,系,剂,迄,继,忌,器,泣,击,欺,极,季,漆,记,砌,纪,妓,济,栖,乞,辑,荠,计,七,疾,既,及,己,急,凄,妻,给,鲫,挤,契,汽,岂,棘,企
奈	乃,奶,耐	
奄	燕,烟,咽,殷,厌,淹	掩,咽,艳,盐,炎,堰,延,癌,衍,颜,沿,砚,阎,眼,焰,演,雁,验,宴,严,研,谚,言,唁
奔		本,笨
妻	弃,溪,气,凄,漆,砌,栖,企,柒,迄,汽,契,器,泣,七,戚,欺	祈,期,旗,乞,棋,启,只,崎,鳍,稽,其,起,歧,脐,骑,奇,畦,岂,枝,齐
委	萎,纬,威,苇,伟,偎,尾	谓,巍,魏,味,未,围,喂,遗,畏,胃,薇,位,为,微,桅,伪,维,慰,尉,唯,卫,违,蔚,危
妹	媚,昧	眉,霉,梅,媒,楣,没,枚,每,美,煤,玫
姑	沽,咕,估,家,孤,辜	滑,雇,凸,古,告,固,故,谷,骨,顾,股,鼓,贾
姆	姥,拇,牡,母,亩	沐,牧,幕,募,慕,睦,穆,暮,模,目,墓,木
姐	姊,解	借,界,街,结,揭,皆,洁,诫,阶,劫,捷,介,截,戒,竭,芥,接,杰,届,节
始	屎,使,矢,驶,史	拾,石,恃,失,提,射,誓,侍,适,虱,饰,嗜,士,十,式,拭,事,示,室,尸,释,识,市,什,世,匙,势,实,硕,食,师,是,湿,氏,视,蚀,狮,诗,柿,逝,时,施,试
姓	兴,性,幸,杏	型,刑,星,猩,醒,形,省,腥,行,邢
姊	姐,解	借,界,街,结,揭,皆,洁,诫,阶,劫,捷,介,截,戒,竭,芥,接,杰,届,节
孟	梦	蒙,盟,朦,锰,猛,檬,萌
孤	沽,咕,估,姑,家,辜	滑,雇,凸,古,告,固,故,谷,骨,顾,股,鼓,贾
季	计,技,际,记,济,妓,纪,寄,系,鲫,剂,骑,继,忌,祭,冀,既,荠	吉,吃,即,几,圾,箕,其,稽,集,嫉,鸡,籍,借,脊,级,居,寂,肌,机,叽,击,讥,极,期,唧,激,饥,绩,辑,积,疾,基,及,己,急,奇,挤,畸,棘,迹,给
宗	纵,踪,综,棕	从,总
定	钉,锭,订	盯,丁,鼎,叮,顶
官	冠,观,棺,关	罐,馆,灌,管,贯,惯
宜	谊,蛇,胰,仪,夷,移,遗,姨,疑,一	掖,已,乙,衣,忆,溢,易,肄,倚,屹,亿,意,艺,议,邑,义,医,绎,揖,毅,矣,亦,译,益,尾,椅,逸,翼,漪,奕,液,役,壹,以,依,艾,伊,蚁,抑,疫,异,腋
宙	咒,昼,皱	轴,洲,州,周,舟,帚,肘,粥
宛	挽,婉,碗,冤,渊,晚,鸳,娩	怨,猿,辕,院,园,援,弯,源,完,万,圆,原,远,缘,惋,顽,员,袁,湾,豌,元,玩,愿,丸,腕
尚	上	赏,商,裳,伤,汤,晌
屈	圈,岖,蛆,趋,驱,区,曲,躯	取,漆,渠,娶,趣,去
居	几,箕,其,稽,鸡,沮,肌,机,叽,锯,讥,拘,期,唧,激,饥,绩,积,基,蛆,俱,奇,车,畸,驹,迹	吉,足,拒,吃,技,即,圾,聚,集,祭,冀,嫉,举,剧,籍,借,脊,炬,际,级,寂,寄,棘,系,剂,继,忌,句,巨,具,击,极,惧,季,记,济,纪,妓,辑,荠,计,疾,既,矩,菊,及,己,急,据,橘,鲫,骑,挤,鞠,局,距,给
届	借,界,诫,介,芥,戒,解	街,结,揭,皆,阶,洁,杰,劫,捷,截,竭,接,姊,节,姐
冈	肛,岗,刚,纲,钢,扛,缸	港
岸	按,暗,案	俺,氨,安,鞍,庵
岳	乐,越,悦,钥,跃,月,耀,粤,阅,药,说	约
帘	怜,联,廉,莲,连,镰	炼,敛,练,恋,脸,链
帚	肘	轴,洲,州,周,舟,宙,咒,粥,昼,皱
帖	贴,铁	
帕	怕	耙,趴,爬,扒
幸	兴,杏,辛,性,姓	型,刑,星,猩,醒,形,省,腥,行,邢
店	惦,佃,淀,殿,电,垫,奠,玷,甸	颠,碘,典,点
府	甫,抚,父,斧,脯,俯,辅,腐	辐,符,麸,负,咐,复,副,缚,腹,服,扶,妇,夫,孵,肤,赋,福,俘,附,浮,蝠,付,幅,赴,芙,袱,拂,敷,富,傅,伏
底	抵	芽,涤,嘀,嫡,低,敌,缔,蒂,的,笛,第,帝,地,滴,递,弟
延	癌,阎,严,研,沿,颜,盐,炎,言	燕,掩,眼,衍,验,烟,咽,焰,奄,艳,殷,演,厌,谚,雁,砚,淹,堰,唁,宴
弦	贤,闲,涎,嫌,衔,舷,咸	腺,宪,馅,先,掀,现,铣,鲜,纤,癣,限,显,县,陷,仙,献,险,线
弧	糊,壶,胡,蝴,葫,湖,狐	护,许,乎,唬,沪,虎,互,戏,呼,户,忽
往	网,枉	忘,旺,汪,妄,亡,望,王
征	指,怔,蒸,正,止,狰,旨,睁,争,丁,址,只,纸,趾,症,筝,挣	植,汁,蜘,织,吱,知,直,郑,值,置,芝,枝,滞,治,至,整,证,职,秩,殖,帜,只,之,智,致,识,质,挚,窒,政,脂,症,稚,氏,执,支,拯,肢,掷,制,志
彼	比,笔,鄙,匕	闭,币,毙,蔽,逼,碧,毕,避,璧,泌,壁,弊,鼻,辟,臂,庇,必
忠	终,衷,盅,中,钟	仲,种,重,众,肿
忽	戏,呼,乎	糊,壶,胡,护,蝴,唬,葫,沪,虎,互,湖,狐,许,户,弧
念		年,撵,捻,碾
忿	份,奋,粪,分,愤	吩,坟,芬,纷,粉,焚,氛
怔	正,狰,争,睁,丁,征,症,筝,挣,蒸	拯,政,郑,症,整,证
怯	切,确,壳,鹊,雀,契,却,窃	茄,瘸,且,缺
怖	埠,部,步,不,布,簿	补,捕,卜,哺
怪		拐,乖
怕	帕	耙,趴,爬,扒
性	兴,幸,杏,姓	型,刑,星,猩,醒,形,省,腥,行,邢
或	霍,豁,惑,祸,货,获	活,豁,伙,火,和
房	坊,防,肪,妨	纺,仿,访,方,芳,放
所	琐,锁,索	嗦,缩,唆,梭
承	澄,呈,橙,惩,成,程,乘,城,盛,诚	撑,逞,秤,称
拉	喇,啦	辣,落,腊,蜡
拌	伴,办,半,瓣,绊,扮	版,班,板,扳,颁,搬,般,斑
拄	煮,主,属,嘱,贮	柱,轴,蛀,逐,注,住,蛛,驻,珠,竹,诸,烛,助,朱,铸,株,术,猪,祝,筑
拂	袱,幅,福,辐,俘,符,服,浮,蝠,缚,扶,夫,伏,芙	甫,复,麸,负,咐,腹,妇,辅,孵,父,肤,赋,附,付,抚,斧,赴,腐,脯,府,俯,敷,富,傅,副
抹		墨,末,寞,默,莫,蘑,么,磨,沫,摸,茉,膜,摹,没,魔,摩,模,漠,脉,陌
拒	足,惧,据,炬,俱,聚,锯,句,巨,具,距,剧	菊,蛆,沮,居,橘,车,鞠,矩,举,局,驹,拘
招	着,朝,昭,召,嘲	沼,照,找,爪,赵,罩,兆
披	坏,霹,批,劈,被,匹	疲,譬,否,罢,啤,脾,皮,僻,辟,屁
拓	唾	拖,托,鸵,脱,椭,驮,妥,驼
拔	跋	爸,捌,芭,笆,扒,坝,耙,巴,靶,罢,叭,八,疤,霸,伯,吧,把
抛		跑,袍,炮,咆,泡,刨
抽		稠,酬,愁,丑,臭,筹,畴,绸,仇
押	压,衙,涯,呀,鸦,蚜,牙,芽,鸭	哑,雅,讶,轧,亚
拐		怪,乖
拙	茁,啄,酌,琢,着,卓,灼,浊	桌,捉
拇	姥,牡,母,姆,亩	沐,牧,幕,募,慕,睦,穆,暮,模,目,墓,木
拍		排,牌,湃,派,徘
抵	底	芽,涤,嘀,嫡,低,敌,缔,蒂,的,笛,第,帝,地,滴,递,弟
抱	爆,豹,暴,报,刨	胞,保,褒,雹,苞,宝,饱,包,堡,薄
拘	俱,蛆,沮,居,车,锯,驹	拒,足,惧,菊,炬,剧,据,聚,橘,局,句,鞠,举,巨,具,距,矩
拖	脱,托	唾,鸵,拓,椭,驮,妥,驼
拗	乐,傲,澳,钥,耀,懊,药,奥,要	咬,熬,哟,姚,腰,钮,遥,谣,窑,么,淆,吆,摇,侥,妖,夭,肴,扭,邀,舀,纽,牛,凹,袄
拆	差	豺,柴
抬	台,苔	态,太,泰,汰,胎
放		妨,纺,仿,坊,房,防,访,芳,方,肪
斧	父,抚,甫,脯,府,俯,辅,腐	辐,符,麸,负,咐,复,副,缚,腹,服,扶,妇,夫,孵,肤,赋,福,俘,附,浮,蝠,付,幅,赴,芙,袱,拂,敷,富,傅,伏
旺	忘,望,王,妄	往,汪,枉,亡,网
昔	席,息,习,锡,惜,媳,袭,熄	希,吸,行,溪,稀,隙,牺,系,膝,熙,犀,携,戏,洗,西,悉,晰,喜,栖,嬉,蟋,厘,析,细,夕,徙,畦
易	掖,衣,忆,溢,肄,屹,一,亿,意,艺,邑,义,绎,议,毅,亦,译,益,逸,翼,奕,液,役,谊,艾,腋,抑,疫,异	已,乙,疑,倚,医,揖,夷,移,矣,遗,宜,尾,椅,蛇,漪,姨,壹,以,依,胰,仪,伊,蚁
昌	猖,倡	畅,唱,尝,长,裳,肠,厂,敞,场,常,偿
昆	坤	捆,困
昂		肮
明	鸣,名,铭,螟	命
昏	婚,荤	浑,魂,混
服	袱,幅,拂,福,辐,俘,符,浮,蝠,缚,扶,夫,伏,芙	甫,复,麸,负,咐,腹,妇,辅,孵,父,肤,赋,附,付,抚,斧,赴,腐,脯,府,俯,敷,富,傅,副
朋	澎,蓬,彭,棚,硼,篷,膨,鹏	捧,碰,烹,砰
杭	吭,航,行	
枕	疹,诊,阵,震,镇,振	侦,真,珍,贞,榛,斟,针
东	冬	冻,懂,董,动,洞,栋
果	裹	过,国,锅,郭
枝	吱,汁,蜘,织,知,崎,鳍,其,芝,旗,脐,只,之,祈,期,歧,脂,氏,支,肢,棋,骑,奇,畦,齐	植,气,旨,启,直,起,稽,值,柒,置,滞,治,戚,至,弃,溪,职,秩,殖,帜,智,迄,器,泣,趾,致,欺,识,指,质,止,漆,砌,挚,栖,窒,乞,纸,七,稚,执,凄,妻,掷,址,制,志,契,汽,岂,征,企
林	淋,磷,邻,琳,鳞,临	凛,赁,吝,躏
杯	碑,背,卑,悲	辈,北,备,贝,狈,惫,焙,臂,倍,被
杰	洁,结,劫,捷,截,竭,节	借,界,街,诫,揭,皆,阶,姐,介,芥,接,姊,届,戒,解
板	版	班,伴,办,扳,拌,颁,半,搬,般,瓣,绊,斑,扮
枉	往,网	忘,旺,汪,妄,亡,望,王
松		耸,诵,送,讼,颂,宋
析	西,悉,希,晰,溪,厘,稀,栖,牺,嬉,膝,熙,犀,吸,蟋,行,携,畦	席,息,习,昔,锡,喜,惜,细,夕,隙,系,徙,熄,媳,袭,洗,戏
枚	眉,霉,梅,媒,楣,没,煤,玫	媚,每,美,昧,妹
欣	芯,薪,新,辛,锌,心	衅,信,寻
武	侮,鹉,舞,午,五,捂,伍	屋,于,诬,芜,物,误,污,勿,呜,无,吴,乌,坞,梧,务,蜈,雾,晤,巫,亡,恶,悟
歧	祈,期,旗,棋,只,脐,崎,鳍,奇,其,骑,畦,枝,齐	气,启,起,柒,稽,戚,弃,溪,迄,器,泣,欺,漆,砌,乞,栖,七,凄,妻,契,汽,岂,企
氓	盲,芒,茫,忙	莽
氛	芬,吩,纷,分	份,忿,奋,粪,粉,愤,焚,坟
泣	弃,气,妻,砌,迄,汽,契,器,企	启,起,鳍,稽,柒,其,崎,枝,戚,溪,旗,脐,只,欺,祈,期,漆,乞,栖,歧,七,凄,棋,骑,奇,畦,岂,齐
注	柱,蛀,住,驻,铸,助,祝	轴,逐,猪,煮,蛛,主,竹,诸,属,烛,嘱,朱,拄,株,术,珠,贮,筑
泳	咏,踊,蛹,勇,永,拥	庸,用,佣
泌	闭,蜜,币,庇,毙,蔽,碧,毕,比,避,璧,壁,弊,臂,辟,密,觅,秘,鄙,必	笔,咪,谜,彼,逼,弥,匕,糜,迷,鼻,靡,米
泥	呢,匿,腻,尼,溺,逆	你,拟
河	盒,何,禾,核,荷,合,褐,盖,和	喝,呵,吓,赫,贺,鹤
沽	咕,估,家,姑,孤,辜	滑,雇,凸,古,告,固,故,谷,骨,顾,股,鼓,贾
沾	瞻,毡,占	站,战,斩,盏,颤,暂,崭,展,蘸,栈,绽
沼	找,爪	罩,招,着,朝,昭,赵,照,兆,召,嘲
波	坡,泼	迫,魄,破,颇,泊,婆,朴,剖
沫	墨,末,寞,默,莫,磨,膜,没,漠,茉,脉,陌	么,蘑,摸,摹,魔,抹,摩,模
法	发,阀,筏,伐,罚,乏	发
沸	肺,费,废,吠	飞,匪,啡,菲,诽,肥,非
油	由,犹,游,尤,邮	佑,又,优,幽,悠,幼,诱,右,忧,有,友
况	框,矿,眶,旷	筐,狂
沮	蛆,俱,居,车,矩,锯,举,驹,拘	拒,足,惧,菊,炬,据,具,聚,橘,鞠,句,巨,局,距,剧
沿	咽,艳,盐,炎,堰,延,癌,颜,砚,阎,焰,雁,验,宴,燕,严,研,厌,谚,言,唁,淹	掩,眼,衍,烟,奄,殷,演
治	质,知,挚,识,秩,制,帜,志,窒,智,置,滞,稚,致,至	植,汁,蜘,织,吱,旨,直,值,芝,枝,职,殖,只,之,趾,指,止,纸,脂,氏,执,支,肢,掷,址,征
泡	炮	抛,跑,袍,咆,刨
泛	贩,犯,范,饭	矾,凡,烦,樊,番,繁,翻,帆,反,返
泊	迫,舶,驳,膊,白,魄,搏,破,脖,渤,朴,荸,卜,博,柏,勃,伯,薄	坡,跛,簸,颇,播,婆,拨,剥,玻,般,波,剖,泼,菠
炕	抗	慷,扛,康,糠
炎	延,癌,阎,严,研,沿,颜,盐,言	燕,掩,眼,衍,验,烟,咽,焰,奄,艳,殷,演,厌,谚,雁,砚,淹,堰,唁,宴
炒	吵	钞,巢,朝,抄,超,剿,潮,嘲
炊	吹	锤,垂,捶,椎
爬	耙,扒	帕,怕,趴
争	怔,正,狰,睁,丁,征,症,筝,挣,蒸	拯,政,郑,症,整,证
爸	坝,耙,罢,霸,伯	捌,芭,笆,扒,拔,巴,靶,叭,八,疤,跋,吧,把
版	板	班,伴,办,扳,拌,半,搬,颁,般,瓣,绊,斑,扮
牧	沐,幕,募,慕,睦,穆,暮,目,墓,木	姥,拇,牡,模,母,姆,亩
物	晤,误,坞,勿,务,恶,悟,雾	屋,武,于,芜,污,侮,呜,无,舞,五,吴,乌,梧,蜈,鹉,午,巫,亡,捂,诬,伍
状	撞,壮	妆,装,桩,庄
狗	苟	沟,购,够,句,勾,构,垢,钩
狐	糊,壶,胡,蝴,葫,湖,弧	护,许,乎,唬,沪,虎,互,戏,呼,户,忽
玩	惋,丸,完,顽,万,腕	弯,宛,挽,婉,碗,湾,晚,豌,娩
玫	眉,霉,梅,媒,楣,没,枚,煤	媚,每,美,昧,妹
疙	戈,搁,胳,鸽,割,哥,歌	个,格,葛,阁,合,各,隔,革,蛤
疚	旧,救,臼,舅,究,就	酒,韭,鸠,久,灸,九,揪,玖,纠
的	弟,涤,得,嘀,嫡,蒂,缔,第,笛,帝,地,芽,递,敌	德,低,抵,滴,底
盲	芒,茫,忙,氓	莽
直	植,质,执,职,掷,殖,值	吱,汁,蜘,织,知,旨,置,芝,滞,治,枝,至,秩,只,帜,之,智,趾,致,识,指,止,挚,窒,纸,脂,稚,氏,支,肢,制,址,志,征
知	吱,汁,蜘,织,置,滞,治,芝,枝,至,秩,只,帜,之,智,致,识,质,挚,窒,脂,稚,氏,支,肢,制,志	植,指,执,止,职,旨,掷,殖,址,直,值,纸,趾,征
社	拾,叶,设,舍,射,涉,摄,赦	蛇,舍,什,奢,舌,甚,赊
秉	屏,丙,禀,饼,柄	兵,病,冰,并
空	控	恐,孔
纠	酒,韭,鸠,久,灸,九,揪,玖	旧,救,疚,臼,舅,究,就
者		这,着,宅,浙,摘,遮,哲,折,辙,蔗
肺	费,沸,废,吠	飞,匪,啡,菲,诽,肥,非
肥		费,沸,飞,肺,废,匪,啡,菲,诽,吠,非
肢	吱,汁,蜘,织,支,知,只,之,脂,芝,枝,氏	植,旨,直,值,置,滞,治,至,职,秩,殖,帜,智,趾,致,识,指,质,止,挚,窒,纸,稚,执,掷,制,址,志,征
股	滑,凸,古,谷,骨,鼓,贾	雇,沽,告,故,咕,固,估,顾,家,姑,孤,辜
肩	歼,艰,煎,奸,渐,监,间,溅,坚,兼,尖	箭,见,拣,减,剪,建,捡,件,贱,键,践,鉴,俭,碱,舰,茧,检,简,柬,健,荐,剑,涧
肴	遥,谣,窑,淆,姚,摇,侥	乐,咬,邀,么,哟,舀,钥,吆,拗,耀,妖,夭,腰,药,要
肪	坊,防,房,妨	纺,仿,访,方,芳,放
肯	垦,啃,恳	
卧	握,沃	涡,窝,我
舍	社,拾,叶,设,射,涉,摄,赦	社,蛇,拾,叶,设,什,射,摄,涉,奢,赊,舌,甚,赦
芳	坊,方	妨,纺,仿,房,防,访,放,肪
芝	吱,汁,蜘,织,支,肢,知,只,之,脂,枝,氏	植,旨,直,值,置,滞,治,至,职,秩,殖,帜,智,趾,致,识,指,质,止,挚,窒,纸,稚,执,掷,制,址,志,征
芙	袱,幅,拂,福,辐,俘,符,服,浮,蝠,缚,扶,夫,伏	甫,复,麸,负,咐,腹,妇,辅,孵,父,肤,赋,附,付,抚,斧,赴,腐,脯,府,俯,敷,富,傅,副
芭	捌,扒,笆,巴,叭,八,疤,吧	爸,坝,耙,靶,罢,霸,跋,伯,拔,把
芽	押,涤,衙,嘀,嫡,涯,的,蚜,笛,牙,敌	哑,压,轧,低,雅,讶,呀,蒂,抵,缔,鸦,第,递,帝,地,滴,亚,底,鸭,弟
芹	禽,勤,秦,擒,琴	亲,寝,侵,钦
花	华,哗	滑,话,化,划,桦,猾,豁,画
芬	吩,纷,分,氛	份,忿,奋,粪,粉,愤,焚,坟
芥	借,界,诫,介,届,戒,解	街,结,揭,皆,阶,洁,杰,劫,捷,截,竭,接,姊,节,姐
芯	信,衅,欣,薪,新,辛,锌,心	寻
虎	许,唬	糊,壶,胡,护,乎,蝴,葫,沪,忽,湖,互,狐,呼,户,戏,弧
虱	失,尸,狮,诗,师,施,湿	拾,石,恃,提,射,誓,侍,适,始,饰,嗜,士,十,式,拭,屎,事,示,室,释,识,市,使,矢,什,世,驶,匙,势,实,史,食,硕,是,氏,视,蚀,柿,逝,时,试
初	出	处,厨,触,橱,锄,础,雏,畜,楚,储,除,矗
表		标,彪,膘
轧	讶,亚	押,价,压,哑,衙,雅,涯,呀,鸦,蚜,牙,芽,鸭
迎	萤,赢,蝇,荧,营,盈,莹	影,莺,鹰,婴,应,硬,英,缨,景,鹦,樱,映,颖
返	反	犯,矾,凡,泛,烦,樊,番,饭,繁,翻,贩,范,帆
近	晋,尽,仅,劲,进,禁,浸	津,巾,襟,锦,筋,金,谨,今,紧,斤
采	彩,睬,踩,菜	材,裁,猜,财,菜,才
金	津,巾,襟,筋,禁,今,浸,斤	近,仅,尽,晋,劲,锦,进,谨,紧
长	胀,丈,掌,尝,杖,涨,裳,肠,帐,障,场,常,仗,偿,账	畅,樟,唱,猖,张,彰,厂,敞,倡,章,昌
门	们	闷
阿	啊	噩,哑,遏,讹,鹅,俄,额,蛾,恶,饿,愕,鳄,扼
阻	组,诅,祖	族,足,卒,租
附	父,赋,复,负,咐,副,富,赴,妇,傅,腹,付	甫,辐,符,麸,缚,服,扶,辅,夫,孵,肤,福,俘,浮,蝠,抚,幅,斧,腐,芙,袱,拂,脯,府,俯,敷,伏
雨	羽,宇,屿,语,予,与	狱,隅,预,于,欲,鱼,玉,御,吁,舆,愈,豫,喻,寓,渔,誉,郁,浴,域,裕,迂,愚,淤,育,尉,愉,谷,芋,榆,逾,娱,遇
青	顷,蜻,卿,轻,清,氢,倾	晴,亲,庆,情,请,擎
非	菲,啡,飞	费,沸,肺,废,匪,诽,肥,吠
亭	停,廷,庭,蜓	听,厅,挺,艇
亮	晾,凉,量,谅,辆	粮,良,粱,俩,两,梁
信	绅,身,深,衅,呻,伸,芯,参,申	肾,神,甚,渗,欣,沈,审,婶,寻,薪,新,辛,锌,心,慎
侵	亲,钦	禽,勤,秦,芹,擒,寝,琴
侯	喉,猴	吼,后,厚,候
便	变,辩,辫,辨,遍	蝙,贬,边,骗,编,偏,篇,片,鞭,扁,翩,匾
侠	辖,暇,斜,狭,匣,挟,峡,霞,洽	下,夏,虾,吓,厦,瞎
俏	峭,窍,壳,撬,翘,跷	乔,瞧,鹊,雀,敲,巧,锹,侨,悄,桥,憔
保	宝,饱,堡	胞,薄,暴,爆,苞,雹,褒,豹,包,抱,报,刨
促	趋,醋,错,趣,簇,卒	粗
侣	缕,旅,铝,吕,屡,履,娄	虑,滤,率,绿,氯,驴,律
俘	袱,幅,拂,福,辐,符,服,浮,蝠,缚,扶,夫,伏,芙	甫,复,麸,负,咐,腹,妇,辅,孵,父,肤,赋,附,付,抚,斧,赴,腐,脯,府,俯,敷,富,傅,副
俊	峻,骏,竣,菌	君,钧,窘,尊,龟,均,遵,军
俗		酥,肃,速,宿,素,诉,溯,塑,缩,粟,苏
侮	武,鹉,舞,午,五,捂,伍	屋,于,诬,芜,物,误,污,勿,呜,无,吴,乌,坞,梧,务,蜈,雾,晤,巫,亡,恶,悟
俐	利,立,粒,隶,丽,砾,力,痢,莉,厉,例,雳,吏,历,励,沥,荔,栗	哩,李,里,理,厘,璃,离,漓,篱,梨,犁,礼,狸,鲤,黎
俄	噩,哑,遏,讹,鹅,额,蛾,恶,饿,愕,鳄,扼	阿
冒	贸,貌,帽,茂	矛,毛,猫,锚,茅
冠	观,罐,关,棺,灌,贯,官,惯	馆,管
刹	岔,差	插,叉,茶,喳,查,察
剃	屉,替,惕,涕	堤,题,提,体,梯,踢,剔,蹄,啼
削	雪,穴,哮,销,萧,嚣,血,硝,宵,箫,消	小,靴,薛,啸,酵,校,学,肖,效,孝,笑,晓
前	钱,钳,黔,干,潜	浅,铅,千,遣,谴,嵌,迁,纤,牵,谦,签,歉,欠
则	贼,择,泽,窄,责	怎,侧
勇	咏,踊,蛹,泳,永,拥	庸,用,佣
勉	缅,免,冕,娩	棉,绵,面,眠
勃	舶,白,膊,驳,搏,脖,泊,渤,荸,卜,博,柏,伯,薄	跛,簸,播,拨,剥,玻,般,菠
劲	径,近,境,竞,仅,晋,尽,静,净,进,靖,敬,禁,镜,浸,竟	兢,襟,晶,谨,鲸,颈,惊,津,精,锦,筋,警,更,睛,茎,京,金,荆,今,紧,井,斤,巾,阱,景,经
南	男,难	
却	确,壳,鹊,雀,怯	瘸,缺
厚	后,候	喉,吼,猴,侯
叛	判,畔,盼	盘,潘,般,胖,攀
咬	舀,夭	遥,乐,邀,谣,么,窑,哟,钥,淆,吆,拗,姚,耀,妖,肴,腰,药,要,摇,侥
哀	哎,挨,埃,唉	矮,隘,艾,碍,爱,蔼
咨	姿,吱,滋,资	紫,字,自,滓,籽,仔,子
哎	哀,挨,埃,唉	矮,隘,艾,碍,爱,蔼
咸	贤,涎,闲,嫌,衔,弦,舷	腺,宪,馅,先,掀,现,铣,鲜,纤,癣,限,显,县,陷,仙,献,险,线
咳	慨,卡,壳	开,揩,棵,还,科,课,骇,坷,颗,可,苛,客,咖,害,克,楷,亥,凯,孩,哈,刻,海,磕,岂,渴,蝌
咽	艳,射,页,堰,夜,沿,砚,业,叶,谒,焰,奄,殷,雁,验,宴,燕,烟,研,厌,谚,唁,淹	延,癌,爷,冶,眼,阎,掩,野,严,奄,殷,也,衍,烟,演,颜,盐,炎,言,椰
咪		蜜,谜,泌,弥,糜,迷,密,靡,觅,秘,米
品		濒,聘,贫,拼,频
哄	轰,烘	汞,鸿,宏,红,虹,洪
哈	咖	咳,蛤,卡
咱	砸,杂	赞,暂
咧		烈,劣,列,猎,裂
垂	锤,捶,椎	吹,炊
型	形,刑,邢,行	兴,幸,猩,星,性,醒,腥,杏,省,姓
垢	购,够,构	苟,沟,狗,句,勾,钩
城	澄,呈,橙,惩,承,成,程,乘,盛,诚	撑,逞,秤,称
垮		夸,胯,跨
奕	掖,衣,忆,溢,肄,易,屹,一,亿,意,艺,邑,义,绎,议,毅,亦,译,益,逸,翼,液,役,谊,艾,腋,抑,疫,异	已,乙,疑,倚,医,揖,夷,移,矣,遗,宜,尾,椅,蛇,漪,姨,壹,以,依,胰,仪,伊,蚁
契	泻,气,楔,窃,解,切,骇,弃,卸,谢,迄,器,泣,怯,砌,械,蟹,屑,懈,屉,妻,汽,企	启,起,鳍,稽,写,柒,其,崎,枝,戚,溪,谐,旗,些,脐,只,携,欺,祈,期,协,漆,乞,斜,栖,茄,胁,歧,七,歇,且,邪,凄,棋,鞋,骑,奇,血,挟,畦,岂,齐
奏	骤,揍	走
姜	将,浆,僵,疆,江,缰	奖,强,桨,酱,蒋,降,匠,讲
姿	吱,咨,滋,资	紫,字,自,滓,籽,仔,子
姨	谊,蛇,胰,仪,夷,移,遗,疑,宜,一	掖,已,乙,衣,忆,溢,易,肄,倚,屹,亿,意,艺,议,邑,义,医,绎,揖,毅,矣,亦,译,益,尾,椅,逸,翼,漪,奕,液,役,壹,以,依,艾,伊,蚁,抑,疫,异,腋
娃		挖,袜,蛙,洼,瓦
姥	拇,牡,母,姆,亩,老	沐,牧,幕,木,慕,目,烙,捞,络,睦,牢,穆,暮,模,募,墓,唠,劳,酪
姚	遥,谣,窑,淆,肴,摇,侥	邀,乐,咬,么,哟,舀,吆,钥,拗,耀,妖,夭,腰,药,要
威	萎,偎,委	谓,巍,魏,味,未,围,喂,遗,畏,伟,尾,胃,薇,位,为,微,伪,桅,维,纬,慰,尉,唯,卫,违,苇,蔚,危
姻	因,音,殷,茵,阴	隐,银,瘾,淫,引,吟,印,听,蚓,饮
孩	还	害,海,亥,咳,骇
宣	轩,喧	悬,炫,还,漩,玄,县,选,旋
宦	焕,痪,幻,涣,唤,患,换	环,还,缓,欢
室	恃,适,誓,侍,饰,嗜,士,式,拭,事,示,释,识,市,使,世,势,是,氏,视,柿,逝,试	拾,石,提,失,射,始,虱,十,屎,尸,矢,什,驶,匙,实,史,食,师,硕,湿,蚀,狮,诗,时,施
客	克,可,课,刻	坷,颗,壳,棵,科,磕,咳,苛,渴,蝌
封	疯,峰,风,蜂,讽,丰,枫,锋	冯,奉,凤,逢,缝
屎	使,矢,始,驶,史	拾,石,恃,失,提,射,誓,侍,适,虱,饰,嗜,士,十,式,拭,事,示,室,尸,释,识,市,什,世,匙,势,实,硕,食,师,是,湿,氏,视,蚀,狮,诗,柿,逝,时,施,试
屏	丙,冯,凭,坪,苹,平,禀,饼,评,秉,柄,萍,瓶	病,冰,乒,并,兵
屋	污,呜,于,巫,恶,诬,乌	武,芜,物,误,侮,勿,无,舞,五,吴,坞,梧,务,蜈,雾,晤,鹉,午,亡,捂,悟,伍
巷	向,乡,像,相,橡,项,象	响,镶,享,箱,祥,想,详,厢,降,香,湘,翔
帝	缔,的,第,蒂,地,递,弟	涤,嘀,嫡,低,滴,抵,笛,芽,底,敌
帅	率,数,蟀,烁,勺,硕	摔,甩,说,衰
幽	优,悠,忧	佑,又,由,犹,油,幼,右,游,诱,邮,尤,有,友
度	妒,惰,肚,渡,踱,跺,舵,驮,镀,杜,堕	躲,睹,牍,朵,读,多,毒,夺,督,都,赌,独,堵
建	舰,健,箭,荐,剑,见,件,贱,渐,键,监,涧,间,溅,践,鉴	碱,肩,俭,茧,歼,艰,煎,奸,拣,减,剪,检,简,坚,兼,捡,尖,柬
很	狠	痕,恨
待	带,逮,大,代,怠,贷,呆,袋,戴	歹
徊	怀,槐,淮	坏
律	虑,滤,率,绿,氯	缕,旅,铝,侣,吕,驴,娄,履,屡
怒		努,奴
思	私,撕,司,丝,斯,嘶	伺,肆,四,赐,食,饲,死,寺,似
怠	带,逮,待,大,代,戴,贷,袋	呆,歹
急	吉,极,借,及,吃,脊,唧,即,圾,级,寂,集,辑,嫉,击,疾,棘,籍	技,几,箕,其,稽,祭,冀,鸡,际,居,肌,寄,系,剂,继,机,忌,叽,讥,期,季,激,饥,记,济,绩,纪,妓,荠,计,积,既,基,己,鲫,骑,奇,挤,畸,迹,给
怨	远,院,愿	袁,援,宛,缘,源,猿,辕,员,园,渊,冤,圆,原,鸳,元
恍	谎,幌,晃	惶,皇,凰,黄,慌,蝗,煌,荒
恰	洽	卡
恨		狠,痕,很
恢	灰,辉,徽,挥,堕	慧,绘,惠,悔,贿,讳,汇,毁,晦,茴,诲,会,溃,蛔,秽,虫,回
恒	横,衡	哼
恃	适,誓,侍,饰,嗜,士,式,拭,事,示,室,释,识,市,使,世,势,是,氏,视,柿,逝,试	拾,石,提,失,射,始,虱,十,屎,尸,矢,什,驶,匙,实,史,食,师,硕,湿,蚀,狮,诗,时,施
恬	甜,田,填	添,舔,天
恤	叙,絮,旭,绪,酗,婿,蓄,续,畜,序	徐,吁,需,须,许,虚
扁	贬,偏,篇,翩,匾	蝙,边,变,便,骗,辩,辫,辨,编,片,鞭,遍
拜	败	百,白,摆
挖	洼,蛙	袜,瓦,娃
按	暗,案,岸	俺,氨,安,鞍,庵
拼		濒,聘,品,贫,频
拭	恃,适,誓,侍,饰,嗜,士,式,事,示,室,释,识,市,使,世,势,是,氏,视,柿,逝,试	拾,石,提,失,射,始,虱,十,屎,尸,矢,什,驶,匙,实,史,食,师,硕,湿,蚀,狮,诗,时,施
持	池,迟,驰,匙,弛	吃,嗤,齿,侈,翅,斥,耻,赤,尺
指	止,旨,只,址,纸,趾,征	植,汁,蜘,织,吱,知,直,值,置,芝,滞,治,枝,至,职,秩,殖,帜,只,之,智,致,识,质,挚,窒,脂,稚,氏,执,支,肢,掷,制,志
拱	矿,巩,汞,共	蚣,贡,宫,功,红,攻,弓,恭,工,躬,供,公
拷	考,烤	铐,靠
拯	整	怔,正,狰,睁,争,丁,政,郑,证,征,症,筝,挣,蒸
括	瓜,刮,扩,蜗,廓,阔	褂,挂,卦,寡
拾	社,叶,石,设,提,舍,射,什,蚀,涉,实,时,硕,食,摄,十,赦	恃,失,适,誓,侍,始,虱,饰,嗜,士,舌,甚,式,拭,屎,事,示,室,尸,释,识,蛇,市,使,矢,世,驶,匙,势,奢,史,师,是,湿,氏,视,舍,狮,诗,赊,柿,逝,施,试
拴	栓	涮
挑		条,跳,调
挂	褂,卦	括,瓜,刮,寡,蜗
政	正,郑,症,挣,证	怔,拯,狰,睁,争,丁,整,症,征,筝,蒸
故	雇,告,固,估,顾	滑,凸,古,沽,咕,谷,骨,孤,股,鼓,姑,家,贾,辜
施	失,尸,狮,诗,虱,师,湿	拾,石,恃,提,射,誓,侍,适,始,饰,嗜,士,十,式,拭,屎,事,示,室,释,识,市,使,矢,什,世,驶,匙,势,实,史,食,硕,是,氏,视,蚀,柿,逝,时,试
既	计,技,季,际,记,济,妓,纪,寄,系,鲫,剂,骑,继,忌,祭,冀,荠	吉,吃,即,几,圾,箕,其,稽,集,嫉,鸡,籍,借,脊,级,居,寂,肌,机,叽,击,讥,极,期,唧,激,饥,绩,辑,积,疾,基,及,己,急,奇,挤,畸,棘,迹,给
春		唇,纯,醇,淳,蠢
昭	招,着,朝,召,嘲	沼,照,找,爪,赵,罩,兆
映	应,硬	萤,鹰,赢,影,婴,莺,蝇,樱,迎,荧,营,英,缨,景,鹦,盈,莹,颖
昧	媚,妹	眉,霉,梅,媒,楣,没,枚,每,美,煤,玫
星	兴,猩,腥	幸,型,刑,醒,邢,形,省,行,杏,性,姓
昨	作	坐,座,凿,左,做
柿	恃,适,誓,侍,饰,嗜,士,式,拭,事,示,室,释,识,市,使,世,势,是,氏,视,逝,试	拾,石,提,失,射,始,虱,十,屎,尸,矢,什,驶,匙,实,史,食,师,硕,湿,蚀,狮,诗,时,施
染		燃,然
柱	蛀,注,住,驻,铸,助,祝	轴,逐,猪,煮,蛛,主,竹,诸,属,烛,嘱,朱,拄,株,术,珠,贮,筑
柔	蹂,揉	肉
某		谋
柬	碱,茧,拣,减,剪,检,简,俭,捡	箭,见,建,歼,艰,煎,件,贱,键,践,鉴,舰,肩,渐,监,间,坚,尖,健,荐,剑,奸,涧,溅,兼
架	稼,价,假,驾,嫁,贾	夏,夹,佳,茄,甲,挟,钾,嘉,加,荚,家,颊
枯	窟,哭	酷,裤,苦,库
栅	诈,乍,炸	闸,喳,查,眨,渣,扎
柄	屏,丙,禀,饼,秉	兵,病,冰,并
柑	杆,竿,甘,肝,干	敢,杆,赶,感,秆,橄,干
查	茶,喳,察,渣,扎	插,叉,炸,乍,刹,差,闸,眨,诈,岔,栅
柏	舶,白,膊,驳,搏,脖,泊,渤,荸,卜,博,勃,伯,薄	跛,簸,播,拨,剥,玻,般,菠
柳	铆	留,瘤,刘,流,馏,榴,陆,琉,溜,硫,六,泵
柒	溪,凄,漆,妻,栖,七,戚,欺	气,启,起,鳍,稽,其,崎,枝,弃,旗,脐,只,迄,器,泣,祈,期,乞,砌,歧,齐,棋,骑,奇,契,畦,汽,岂,企
歪		舀,外
殃	秧,央,鸯	养,阳,氧,扬,样,羊,漾,仰,洋,杨,痒
段	断,缎,锻	端,短
毒	牍,独,读	睹,妒,肚,渡,督,都,赌,度,镀,杜,堵
泉	卷,全,权,拳,痊,犬	圈,券,劝
洋	杨,羊,阳,扬	养,央,氧,样,鸯,漾,仰,殃,秧,痒
洲	粥,周,舟,州	轴,帚,宙,咒,肘,昼,皱
洪	虹,红,鸿,宏	轰,烘,哄,汞
流	留,瘤,刘,榴,琉,硫,泵	馏,陆,铆,柳,溜,六
津	巾,襟,筋,金,禁,今,浸,斤	近,仅,尽,晋,劲,锦,进,谨,紧
洞	动,冻,栋	董,东,懂,冬
洗	喜,徙	息,希,习,吸,行,席,溪,锡,稀,隙,牺,系,膝,熙,犀,携,媳,戏,熄,西,悉,晰,惜,栖,嬉,蟋,厘,析,昔,细,夕,畦,袭
活		霍,豁,惑,伙,火,货,祸,获,和,或
洽	侠,恰,辖,暇,斜,狭,匣,挟,峡,霞	下,夏,卡,虾,吓,厦,瞎
派	湃	排,拍,牌,徘
汹	兄,凶,胸,匈	熊,雄
洛	烙,络,骆,落,酪	罗,螺,萝,骡,箩,逻,裸,锣
泵	留,瘤,刘,流,榴,琉,硫	馏,陆,铆,柳,溜,六
炫	漩,旋	悬,还,玄,轩,喧,县,选,宣
为	谓,巍,魏,味,未,围,喂,遗,畏,胃,薇,位,微,伪,桅,维,慰,尉,唯,卫,违,蔚,危	萎,威,苇,委,伟,偎,纬,尾
炬	拒,足,惧,俱,据,聚,锯,句,巨,具,距,剧	菊,蛆,沮,居,橘,车,鞠,矩,举,局,驹,拘
炭	探,叹,碳	谈,瘫,昙,袒,坦,贪,潭,痰,谭,坛,滩,摊,弹,檀,毯
炸	乍,闸,诈,扎,栅	查,眨,渣,喳
炮	袍,泡,咆,刨	抛,跑
牲	生,胜,升,声,甥,笙	绳,剩,乘,圣,省,盛
狠	很	痕,恨
狡	搅,缴,矫,角,绞,脚,剿,较,饺,侥	窖,蕉,教,焦,叫,觉,椒,骄,嚼,交,校,郊,礁,浇,轿,胶,娇
玷	惦,佃,淀,殿,电,店,垫,奠,甸	颠,碘,典,点
珊	删,山,衫,扇,杉	善,赡,陕,膳,擅,闪,单
玻	播,拨,剥,般,菠	跛,舶,驳,膊,白,簸,搏,脖,泊,渤,荸,卜,博,柏,勃,伯,薄
玲	铃,凌,龄,零,菱,陵,翎,蛉,伶,灵	另,岭,领,令
珍	侦,诊,真,贞,榛,斟,针	疹,枕,阵,镇,震,振
甚	肾,蛇,神,渗,什,舌,慎	拾,射,参,申,社,呻,信,伸,设,摄,赦,身,叶,沈,审,婶,涉,奢,绅,深,舍,赊
畏	慰,胃,魏,尉,味,未,卫,位,喂,为,遗,谓,蔚,伪	危,薇,萎,威,唯,苇,违,委,偎,围,微,伟,桅,巍,维,纬,尾
界	借,诫,介,芥,届,戒,解	街,结,揭,皆,阶,洁,杰,劫,捷,截,竭,接,姊,节,姐
疫	掖,衣,忆,溢,肄,易,屹,一,亿,意,艺,邑,义,绎,议,毅,亦,译,益,逸,翼,奕,液,役,谊,艾,腋,抑,异	已,乙,疑,倚,医,揖,夷,移,矣,遗,宜,尾,椅,蛇,漪,姨,壹,以,依,胰,仪,伊,蚁
疤	捌,扒,芭,笆,巴,叭,八,吧	爸,坝,耙,靶,罢,霸,跋,伯,拔,把
皆	街,结,揭,阶,接	借,界,诫,洁,劫,捷,姊,姐,介,截,戒,竭,芥,杰,届,节,解
皇	惶,凰,黄,蝗,煌	恍,谎,幌,慌,晃,荒
盈	萤,赢,迎,蝇,荧,营,莹	影,莺,鹰,婴,应,硬,英,缨,景,鹦,樱,映,颖
盆		喷
盅	终,忠,衷,中,钟	仲,种,重,众,肿
省	醒	星,声,绳,腥,行,邢,型,幸,胜,猩,剩,乘,生,升,形,甥,圣,笙,牲,刑,姓,杏,性,盛
盹	盾,顿,吨,钝,囤	墩,蹲,敦
相	向,镶,箱,乡,像,厢,橡,巷,香,湘,项,象	响,享,祥,想,降,详,翔
眉	霉,梅,媒,楣,没,枚,煤,玫	媚,每,美,昧,妹
看	勘,堪,刊	坎,砍
盾	顿,吮,吨,钝,囤,盹	蹲,墩,敦,顺,瞬
盼	叛,判,畔	盘,潘,般,胖,攀
砂	沙,煞,杀,纱,杉	厦,霎,傻
研	咽,艳,盐,炎,堰,延,癌,颜,沿,砚,阎,焰,雁,验,宴,燕,严,厌,谚,言,唁,淹	掩,眼,衍,烟,奄,殷,演
砌	弃,气,妻,迄,汽,契,器,泣,企	启,起,鳍,稽,柒,其,崎,枝,戚,溪,旗,脐,只,欺,祈,期,漆,乞,栖,歧,七,凄,棋,骑,奇,畦,岂,齐
砍	坎	看,勘,堪,刊
祈	期,旗,棋,脐,只,崎,鳍,奇,其,骑,歧,畦,枝,齐	气,启,起,柒,稽,戚,弃,溪,迄,器,泣,欺,漆,砌,乞,栖,七,凄,妻,契,汽,岂,企
科	刻,颗,棵,磕,苛,蝌	坷,壳,克,可,咳,课,客,渴
秒	渺,藐	瞄,苗,妙,描,庙
秋	丘,龟,蚯	囚,求,仇,球
穿	川	传,船,串,喘
突	屠,凸,涂,图,途,徒	秃,土,吐,兔
竿	柑,杆,甘,肝,干	敢,杆,赶,感,秆,橄,干
籽	紫,仔,子,滓	吱,资,字,自,滋,姿,咨
红	蚣,功,宫,共,鸿,宏,攻,虹,洪,弓,恭,工,躬,供,公	贡,巩,哄,汞,烘,轰,矿,拱
纪	计,技,季,际,记,济,妓,寄,系,鲫,剂,骑,继,忌,祭,冀,既,荠	吉,吃,即,几,圾,箕,其,稽,集,嫉,鸡,籍,借,脊,级,居,寂,肌,机,叽,击,讥,极,期,唧,激,饥,绩,辑,积,疾,基,及,己,急,奇,挤,畸,棘,迹,给
纫	刃,韧,任,认,赁	人,仁,儿,忍
约		乐,越,悦,钥,跃,月,耀,粤,阅,岳,药,说
缸	肛,岗,刚,纲,钢,冈,扛	港
美	每	媚,眉,霉,梅,媒,楣,没,枚,昧,煤,妹,玫
耐	奈	乃,奶
耍		刷
胖	般,盘	膀,螃,潘,判,盼,庞,叛,磅,攀,旁,畔,乓
胚	坏	配,培,赔,陪,佩,沛
胃	慰,魏,尉,味,未,卫,位,喂,为,遗,谓,蔚,伪,畏	危,薇,萎,威,唯,苇,违,委,偎,围,微,伟,桅,巍,维,纬,尾
背	辈,杯,卑,备,贝,狈,碑,惫,焙,臂,倍,被,悲	北
胡	糊,壶,蝴,葫,湖,狐,弧	护,乎,唬,呼,沪,虎,互,戏,许,户,忽
胎	苔	态,太,泰,台,汰,抬
胞	褒,苞,包	暴,保,爆,刨,宝,雹,豹,饱,堡,抱,报,薄
致	质,知,挚,识,窒,秩,制,帜,志,智,治,置,滞,稚,至	植,汁,蜘,织,吱,旨,直,值,芝,枝,职,殖,只,之,趾,指,止,纸,脂,氏,执,支,肢,掷,址,征
范	泛,贩,犯,饭	矾,凡,烦,樊,番,繁,翻,帆,反,返
茅	锚,矛,毛	冒,猫,茂,贸,帽,貌
苛	刻,颗,棵,科,磕,蝌	坷,壳,克,可,咳,课,客,渴
苦		裤,窟,枯,库,哭,酷
茄	夹,佳,嘉,加,家	切,稼,夏,价,假,且,驾,架,甲,挟,钾,契,嫁,荚,怯,贾,窃,颊
若	弱,惹	热
茂	冒,贸,貌,帽	矛,毛,猫,锚,茅
茉	墨,末,寞,默,沫,莫,磨,膜,没,漠,脉,陌	么,蘑,摸,摹,魔,抹,摩,模
苗	描,瞄	渺,秒,妙,藐,庙
英	鹰,莺,应,婴,缨,鹦,樱	萤,赢,影,硬,迎,蝇,荧,营,景,盈,映,莹,颖
茁	啄,酌,琢,着,卓,灼,浊,拙	桌,捉
苔	台,抬,胎	汰,态,泰,太
苞	胞,褒,包	暴,保,爆,刨,宝,雹,豹,饱,堡,抱,报,薄
苟	狗	沟,购,够,句,勾,构,垢,钩
虐	疟	
虹	宏,红,洪,鸿	轰,烘,哄,汞
衍	演,掩,眼	咽,艳,盐,炎,堰,延,癌,颜,沿,砚,阎,焰,奄,殷,雁,验,宴,燕,严,烟,研,厌,谚,言,唁,淹
衫	删,山,扇,珊,杉	善,赡,陕,膳,擅,闪,单
计	技,季,际,记,济,妓,纪,寄,系,鲫,剂,骑,继,忌,祭,冀,既,荠	吉,吃,即,几,圾,箕,其,稽,集,嫉,鸡,籍,借,脊,级,居,寂,肌,机,叽,击,讥,极,期,唧,激,饥,绩,辑,积,疾,基,及,己,急,奇,挤,畸,棘,迹,给
订	钉,定,锭	盯,丁,鼎,叮,顶
贞	侦,诊,真,珍,榛,斟,针	疹,枕,阵,镇,震,振
负	父,赋,复,附,咐,副,赴,富,妇,傅,腹,付	甫,辐,符,麸,缚,服,扶,辅,夫,孵,肤,福,俘,浮,蝠,抚,幅,斧,腐,芙,袱,拂,脯,府,俯,敷,伏
赴	父,赋,复,附,咐,负,副,富,腹,妇,傅,付	甫,辐,符,麸,缚,服,扶,辅,夫,孵,肤,福,俘,浮,蝠,抚,幅,斧,腐,芙,袱,拂,脯,府,俯,敷,伏
趴		扒,耙,帕,爬,怕
军	君,龟,均,钧	俊,窘,峻,骏,竣,菌
轨	鬼,诡	规,瑰,闺,龟,柜,贵,桂,归,傀,跪
述	竖,漱,数,曙,束,恕,署,树,墅,术,庶,疏	鼠,薯,抒,枢,熟,蜀,梳,暑,书,叔,淑,属,舒,蔬,赎,殊,输,黍
迫	泊,魄,朴,破	坡,颇,婆,波,剖,泼
郊	蕉,教,焦,椒,骄,交,礁,浇,胶,娇	窖,搅,缴,叫,觉,轿,狡,矫,嚼,角,侥,校,脚,剿,较,饺,绞
郎	廊,琅,狼,榔	朗,浪
郁	狱,预,语,欲,玉,御,愈,吁,豫,喻,寓,誉,浴,域,裕,育,尉,谷,芋,与,遇	隅,羽,雨,屿,宇,愉,于,迂,鱼,愚,予,榆,逾,淤,渔,娱,舆
重	仲,种,崇,众,中,虫	终,忠,盅,充,宠,衷,肿,冲,钟
限	腺,宪,现,馅,县,陷,献,线	贤,险,先,闲,涎,掀,嫌,铣,鲜,衔,弦,纤,舷,显,癣,仙,咸
陋	露,漏	搂,篓,娄,楼
陌	墨,末,寞,默,沫,莫,磨,没,漠,茉,脉,膜	么,蘑,摸,摹,魔,抹,摩,模
降	将,祥,强,酱,详,匠,翔	奖,向,乡,桨,浆,蒋,僵,疆,香,湘,江,镶,箱,想,像,橡,讲,象,响,厢,相,享,巷,姜,项,缰
面		冕,免,勉,棉,绵,缅,眠,娩
革	格,葛,阁,合,隔,蛤	个,搁,戈,胳,鸽,疙,割,哥,歌
韭	酒,久,灸,九,玖,纠	旧,救,疚,鸠,臼,舅,究,就,揪
音	因,姻,殷,茵,阴	隐,银,瘾,淫,引,吟,印,听,蚓,饮
页	叶,谒,夜,咽,射,业	爷,冶,野,也,椰
风	疯,峰,蜂,讽,封,丰,枫,锋	冯,奉,凤,逢,缝
飞	菲,啡,非	费,沸,肺,废,匪,诽,肥,吠
食	拾,石,伺,提,四,什,射,赐,肆,蚀,寺,饲,实,硕,时,十,似	恃,失,思,适,誓,侍,始,虱,饰,死,嗜,士,式,拭,屎,事,示,室,尸,释,丝,嘶,识,撕,市,使,矢,世,驶,匙,势,史,斯,师,是,湿,氏,私,视,狮,诗,柿,逝,司,施,试
首	手,守	寿,熟,收,瘦,售,授,受,兽
香	镶,箱,乡,厢,相,湘	响,向,享,祥,想,详,像,降,橡,巷,项,象,翔
乘	澄,胜,呈,橙,惩,承,成,程,剩,圣,城,盛,诚	生,升,绳,逞,称,声,秤,甥,牲,撑,省,笙
倍	辈,备,贝,狈,背,惫,焙,臂,被	北,杯,卑,碑,悲
俯	甫,抚,父,斧,府,脯,辅,腐	辐,符,麸,负,咐,复,副,缚,腹,服,扶,妇,夫,孵,肤,赋,福,俘,附,浮,蝠,付,幅,赴,芙,袱,拂,敷,富,傅,伏
倦	圈,绢,卷,眷	捐,鹃,身
俩	两	晾,粮,良,凉,粱,亮,量,谅,辆,梁
值	植,质,执,职,掷,殖,直	吱,汁,蜘,织,知,旨,置,芝,滞,治,枝,至,秩,只,帜,之,智,趾,致,识,指,止,挚,窒,纸,脂,稚,氏,支,肢,制,址,志,征
借	吉,界,吃,即,圾,介,集,嫉,籍,解,诫,脊,级,寂,芥,击,极,唧,辑,疾,届,及,急,棘,戒	街,技,皆,几,箕,其,稽,祭,冀,接,鸡,节,结,洁,际,居,捷,肌,寄,截,系,剂,竭,机,继,忌,姊,叽,讥,期,揭,季,激,饥,记,济,绩,纪,妓,计,积,既,基,己,阶,劫,给,鲫,骑,奇,挤,畸,杰,迹,荠,姐
倚	椅,已,乙,蚁,矣,以,尾	掖,衣,忆,溢,易,肄,疑,屹,一,亿,意,艺,议,邑,义,医,绎,揖,毅,夷,移,遗,亦,译,宜,益,蛇,逸,翼,漪,奕,姨,液,役,壹,依,谊,胰,艾,仪,伊,抑,疫,异,腋
倒	祷,蹈,导,到,岛,盗,捣,悼,道,稻	叨,刀
们	门	闷
俺		按,岸,氨,鞍,庵,安,暗,案
倔	诀,觉,掘,嚼,角,绝,脚,决,爵	
俱	拒,足,惧,驹,蛆,炬,据,沮,居,聚,车,锯,句,巨,具,距,剧,拘	菊,橘,鞠,举,局,矩
倡	畅,唱,猖,昌	尝,长,裳,肠,厂,敞,常,场,偿
个	各	格,葛,阁,蛤,搁,戈,胳,鸽,合,革,隔,疙,割,哥,歌
候	后,厚	喉,吼,猴,侯
倘	躺,淌	烫,塘,膛,搪,汤,趟,堂,糖,唐,棠
修	休,羞	绣,宿,臭,秀,锈,朽,嗅,袖
伦	论,轮,沦,抡,仑	
仓	舱,苍,沧	藏
兼	肩,歼,艰,煎,奸,渐,监,间,溅,坚,尖	箭,见,拣,减,剪,建,捡,件,贱,键,践,鉴,俭,碱,舰,茧,检,简,柬,健,荐,剑,涧
冤	鸳,宛,渊	援,远,怨,缘,愿,源,辕,猿,院,员,园,袁,圆,原,元
冻	洞,栋,动	董,东,懂,冬
凌	铃,玲,龄,零,菱,陵,翎,蛉,伶,灵	另,岭,领,令
准		屯,谆
剖	颇	迫,坡,魄,破,泊,婆,朴,波,泼
剔	梯,踢	剃,堤,屉,提,体,啼,题,涕,替,蹄,惕
刚	肛,岗,纲,钢,冈,扛,缸	港
剥	播,拨,玻,般,菠	跛,舶,驳,膊,白,簸,搏,脖,泊,渤,荸,卜,博,柏,勃,伯,薄
匪	菲,诽	费,沸,飞,肺,废,啡,肥,吠,非
卿	顷,青,蜻,轻,清,氢,倾	晴,亲,庆,情,请,擎
原	援,缘,源,辕,猿,员,园,袁,圆,元	宛,远,怨,愿,院,冤,渊,鸳
哨	少,召,绍	芍,勺,梢,烧,稍,捎
唐	塘,膛,搪,堂,糖,棠	烫,淌,汤,趟,倘,躺
唁	燕,验,咽,焰,艳,研,沿,谚,厌,雁,砚,淹,堰,宴	延,癌,掩,阎,严,衍,烟,眼,奄,殷,演,颜,盐,炎,言
哼		横,恒,衡
哥	搁,戈,胳,鸽,疙,割,歌	个,格,葛,阁,合,各,隔,革,蛤
哲	折,辙,摘	这,着,宅,浙,遮,蔗,者
唆	嗦,缩,梭	所,琐,锁,索
哺	补,捕,卜	埠,怖,部,步,不,布,簿
哩	李,里,理,礼,鲤	立,砾,璃,痢,俐,狸,沥,隶,离,犁,励,粒,丽,厉,篱,梨,雳,历,荔,栗,利,力,厘,莉,漓,例,吏,黎
哭	窟,枯	酷,裤,苦,库
员	蕴,运,援,韵,孕,缘,猿,辕,源,酝,袁,园,圆,原,元,晕	匀,宛,云,远,怨,陨,愿,耘,院,冤,渊,允,鸳
唉	哎,挨,埃,哀	矮,隘,艾,碍,爱,蔼
哮	销,萧,嚣,削,硝,宵,箫,消	小,啸,酵,校,学,肖,效,孝,笑,晓
哪	那,馁	内,娜,钠,捺,纳,拿,呐
唧	吉,吃,即,几,圾,箕,其,稽,集,嫉,鸡,籍,借,脊,级,居,寂,肌,机,叽,击,讥,极,期,激,饥,绩,辑,积,疾,基,及,急,奇,畸,棘,迹	技,祭,冀,际,寄,系,剂,继,忌,季,记,济,纪,妓,荠,计,既,己,鲫,骑,挤,给
唇	纯,醇,淳	蠢,春
圃	谱,浦,普	瀑,朴,葡,脯,仆,铺,扑,暴,菩,蒲
埂	梗,耿	更,羹,耕
埋		麦,迈,卖,脉,买
埃	哎,挨,唉,哀	矮,隘,艾,碍,爱,蔼
夏	下,假,暇,吓,甲,钾,厦,贾	侠,匣,霞,洽,嘉,嫁,峡,稼,价,虾,架,斜,茄,加,家,瞎,颊,夹,佳,辖,驾,狭,挟,荚
套		涛,逃,桃,滔,讨,淘,陶,萄,掏
娘		酿
娜	那,钠,捺,挪,纳,呐	诺,懦,哪,糯,拿
娱	隅,愉,于,榆,鱼,愚,予,逾,渔,舆	狱,雨,屿,预,语,欲,玉,御,吁,愈,豫,羽,喻,寓,誉,郁,浴,域,裕,迂,淤,育,宇,尉,谷,芋,与,遇
娩	冕,宛,挽,婉,碗,免,勉,晚,缅	弯,惋,丸,完,顽,面,万,腕,湾,棉,绵,眠,豌,玩
孙		笋,损
宰	载,仔	在,灾,栽,再
害	亥,骇	咳,还,海,孩
家	夹,沽,佳,茄,咕,估,嘉,姑,加,孤,辜	古,假,滑,甲,股,嫁,贾,稼,雇,凸,价,架,故,顾,钾,颊,夏,告,驾,固,谷,骨,挟,鼓,荚
宴	燕,咽,焰,堰,艳,研,沿,谚,厌,雁,砚,验,唁,淹	延,癌,掩,阎,严,衍,烟,眼,奄,殷,演,颜,盐,炎,言
宫	蚣,功,共,攻,红,弓,恭,工,躬,供,公	贡,巩,汞,矿,拱
宵	哮,销,萧,嚣,削,硝,箫,消	小,啸,酵,校,学,肖,效,孝,笑,晓
容	蓉,绒,融,熔,茸,榕,溶,荣	冗
射	拾,石,咽,提,十,页,社,设,夜,摄,赦,叶,谒,什,涉,实,硕,食,舍,蚀,时,业	恃,失,适,誓,侍,也,始,虱,饰,嗜,士,舌,甚,式,椰,拭,屎,事,示,野,室,尸,释,识,蛇,市,使,爷,冶,矢,世,驶,匙,势,奢,史,师,是,湿,氏,视,舍,狮,诗,赊,柿,逝,施,试
屑	泻,卸,懈,屉,蟹,谢,械,楔,契,骇,解	谐,协,邪,斜,些,鞋,血,胁,写,挟,携,歇
展	盏,崭,斩	占,毡,站,战,颤,暂,瞻,蘸,栈,沾,绽
峭	窍,壳,撬,翘,俏,跷	乔,瞧,鹊,雀,敲,巧,锹,侨,悄,桥,憔
峡	侠,辖,暇,斜,狭,匣,挟,霞,洽	下,夏,虾,吓,厦,瞎
峻	俊,骏,竣,菌	君,钧,窘,龟,均,军
峰	疯,风,蜂,讽,封,丰,枫,锋	冯,奉,凤,逢,缝
岛	祷,倒,导,捣	蹈,到,叨,盗,刀,悼,道,稻
差	插,雌,叉,刹,喳,岔,拆	词,此,磁,伺,刺,辞,次,柴,赐,慈,查,茶,厕,察,祠,瓷,豺
席	息,习,锡,昔,惜,媳,袭,熄	希,吸,行,溪,稀,隙,牺,系,膝,熙,犀,携,戏,洗,西,悉,晰,喜,栖,嬉,蟋,厘,析,细,夕,徙,畦
师	失,尸,狮,诗,虱,施,湿	拾,石,恃,提,射,誓,侍,适,始,饰,嗜,士,十,式,拭,屎,事,示,室,释,识,市,使,矢,什,世,驶,匙,势,实,史,食,硕,是,氏,视,蚀,柿,逝,时,试
库	酷,裤	窟,枯,哭,苦
庭	亭,停,廷,蜓	听,厅,挺,艇
座	作,坐,凿,做	昨,左
弱	若	
徒	屠,凸,涂,图,途,突	秃,土,吐,兔
径	境,竞,静,劲,净,靖,敬,镜,竟	精,京,兢,晶,鲸,警,颈,更,阱,景,睛,荆,惊,经,井,茎
徐		叙,旭,絮,虚,需,绪,酗,蓄,婿,续,须,畜,恤,序,许,吁
耻	齿,尺,侈	吃,池,嗤,持,翅,迟,驰,斥,匙,赤,弛
恐	孔	控,空
恕	述,竖,漱,数,束,曙,署,树,墅,术,庶,疏	鼠,薯,抒,枢,熟,蜀,梳,暑,书,叔,淑,属,舒,蔬,赎,殊,输,黍
恭	蚣,功,宫,共,攻,红,弓,工,躬,供,公	贡,巩,汞,矿,拱
息	席,习,锡,昔,惜,媳,袭,熄	希,吸,行,溪,稀,隙,牺,系,膝,熙,犀,携,戏,洗,西,悉,晰,喜,栖,嬉,蟋,厘,析,细,夕,徙,畦
悄	鹊,巧,雀	峭,瞧,乔,窍,撬,壳,桥,敲,锹,侨,翘,俏,跷,憔
悟	晤,误,坞,勿,务,恶,物,雾	屋,武,于,芜,污,侮,呜,无,舞,五,吴,乌,梧,蜈,鹉,午,巫,亡,捂,诬,伍
悍	焊,汉,翰,憾,旱,撼,汗,捍	韩,喊,罕,函,酣,含,寒,和,涵
悔	贿,毁,诲,会,虫	慧,绘,堕,惠,灰,讳,恢,汇,晦,辉,徽,茴,溃,蛔,秽,挥,回
悦	乐,越,钥,跃,月,耀,粤,阅,岳,药,说	约
扇	善,删,山,赡,衫,珊,擅,膳,杉,单	陕,闪
拳	卷,全,权,痊,泉,犬	圈,券,劝
拿		那,娜,钠,哪,捺,纳,呐
捎	稍,烧,梢	芍,勺,哨,少,绍,召
挟	侠,夹,谐,协,邪,辖,暇,斜,狭,鞋,匣,胁,携,峡,荚,霞,洽,颊	下,泻,假,楔,写,厦,解,骇,卸,些,谢,甲,嘉,嫁,贾,稼,价,虾,架,茄,蟹,吓,械,屑,钾,加,家,歇,瞎,夏,佳,懈,屉,驾,血,契
振	阵,枕,震,镇	疹,侦,诊,真,珍,贞,榛,斟,针
捕	补,卜,哺	埠,怖,部,步,不,布,簿
捂	侮,武,鹉,舞,午,五,伍	屋,于,诬,芜,物,误,污,勿,呜,无,吴,乌,坞,梧,务,蜈,雾,晤,巫,亡,恶,悟
捆		坤,昆,困
捏		孽,镊,聂
捉	桌	茁,啄,酌,琢,着,卓,灼,浊,拙
挺	艇	亭,蜓,厅,庭,听,停,廷
捐	圈,鹃,身	绢,倦,卷,眷
挽	宛,婉,碗,晚,娩	弯,惋,丸,完,顽,万,腕,湾,豌,玩
挪	娜	懦,诺,糯
挫	锉,撮,错,措	搓
挨	哎,埃,唉,哀	矮,隘,艾,碍,爱,蔼
捍	悍,焊,汉,憾,翰,旱,撼,汗	韩,喊,罕,函,酣,含,寒,和,涵
捌	扒,笆,芭,巴,叭,八,疤,吧	爸,坝,耙,靶,罢,霸,跋,伯,拔,把
效	啸,酵,校,孝,肖,笑	哮,小,销,萧,嚣,削,硝,宵,箫,学,消,晓
料	燎,了	辽,聊,疗,缭,撩,僚,嘹,寥,潦
旁	膀,螃,傍,蚌,庞,磅,棒,谤	梆,邦,帮,胖,榜,绑,乓
旅	缕,铝,侣,吕,娄,履,屡	虑,滤,率,绿,氯,驴,律
时	拾,石,提,什,蚀,射,实,硕,食,十	恃,失,适,誓,侍,始,虱,饰,嗜,士,式,拭,屎,事,示,室,尸,释,识,市,使,矢,世,驶,匙,势,史,师,是,湿,氏,视,狮,诗,柿,逝,施,试
晋	近,仅,尽,劲,进,禁,浸	津,巾,襟,锦,筋,金,谨,今,紧,斤
晃	谎,幌,恍	惶,皇,凰,黄,慌,蝗,煌,荒
晒	杀	筛
晌	赏,上	商,裳,伤,汤,尚
朗		廊,狼,浪,郎,榔,琅
校	窖,教,叫,觉,啸,酵,效,孝,轿,较,肖,笑	小,焦,角,交,箫,脚,学,剿,消,娇,蕉,狡,胶,晓,侥,哮,销,萧,嚣,椒,骄,嚼,宵,郊,硝,饺,绞,搅,缴,矫,削,礁,浇
核	盒,何,禾,荷,合,褐,盖,和,河	喝,呵,吓,赫,贺,鹤
案	按,暗,岸	俺,氨,安,鞍,庵
框	筐,况,眶,矿,旷	狂
根	跟	
桂	跪,柜,贵	规,鬼,诡,瑰,闺,龟,轨,归,傀
梳	枢,抒,书,舒,蔬,殊,输,疏	鼠,蜀,树,赎,述,暑,束,恕,黍,薯,竖,曙,淑,属,墅,术,庶,漱,数,熟,叔,署
栗	利,立,粒,隶,丽,砾,力,痢,莉,厉,例,俐,雳,吏,历,励,沥,荔	哩,李,里,理,璃,厘,离,漓,梨,篱,犁,礼,狸,鲤,黎
桌	捉	茁,啄,酌,琢,着,卓,灼,浊,拙
桑	丧	嗓
栽	灾	宰,再,载,仔,在
柴	豺	拆,差
桐	彤,童,瞳,同,铜	筒,通,统,痛,桶
格	葛,阁,合,隔,革,蛤	个,搁,戈,胳,鸽,各,疙,割,哥,歌
桃	涛,逃,陶,萄,淘	讨,套,滔,掏
株	蛛,珠,诸,朱,猪	柱,轴,蛀,逐,注,住,煮,驻,主,竹,属,烛,嘱,拄,铸,术,助,祝,贮,筑
桅	薇,唯,违,围,为,微,维,巍,危	威,委,谓,魏,味,未,喂,遗,畏,伟,尾,胃,位,伪,偎,纬,慰,尉,萎,卫,苇,蔚
栓	拴	涮
殊	枢,抒,梳,书,舒,蔬,输,疏	鼠,蜀,树,赎,述,暑,束,恕,黍,薯,竖,曙,淑,属,墅,术,庶,漱,数,熟,叔,署
殉	讯,训,驯,汛,逊,迅	寻,旬,巡,询,循,勋
殷	因,姻,燕,音,烟,咽,奄,厌,茵,阴,淹	掩,咽,艳,盐,炎,堰,延,癌,隐,衍,颜,听,沿,砚,饮,银,眼,阎,引,焰,吟,演,雁,验,宴,瘾,严,淫,印,研,谚,蚓,言,唁
气	弃,妻,砌,迄,汽,契,器,泣,企	启,起,鳍,稽,柒,其,崎,枝,戚,溪,旗,脐,只,欺,祈,期,漆,乞,栖,歧,七,凄,棋,骑,奇,畦,岂,齐
氧	养,痒,仰	央,杨,阳,扬,样,鸯,羊,漾,殃,秧,洋
氨	安,鞍,庵	按,岸,俺,暗,案
泰	汰,态,太	台,抬,胎,苔
浪		廊,朗,狼,郎,榔,琅
涕	屉,剃,替,惕	堤,题,提,体,梯,踢,剔,蹄,啼
消	哮,销,萧,嚣,削,硝,宵,箫	小,啸,酵,校,学,肖,效,孝,笑,晓
浦	谱,圃,普	瀑,朴,葡,脯,仆,铺,扑,暴,菩,蒲
浸	津,巾,近,仅,尽,晋,襟,劲,进,金,筋,禁,今,斤	谨,紧,锦
海		害,还,亥,咳,骇,孩
浙	蔗,这,宅	着,遮,摘,哲,折,者,辙
涉	社,拾,叶,设,舍,射,摄,赦	蛇,舍,什,奢,舌,甚,赊
浮	幅,袱,拂,福,辐,俘,符,蝠,缚,扶,服,伏,芙	甫,复,负,咐,麸,腹,辅,妇,孵,父,肤,赋,附,付,抚,斧,赴,腐,府,脯,俯,敷,富,傅,副
浴	狱,预,语,欲,玉,御,愈,吁,豫,喻,寓,誉,郁,域,裕,育,尉,谷,芋,与,遇	隅,羽,雨,屿,宇,愉,于,迂,鱼,愚,予,榆,逾,淤,渔,娱,舆
浩	镐,耗,好,号	嚎,壕,豪,毫,鹤,蒿
烘	轰,哄	汞,鸿,宏,红,虹,洪
烤	考,拷	铐,靠
烙	洛,络,骆,落,劳,酪	萝,姥,螺,骡,箩,罗,逻,牢,裸,捞,锣,唠,老
烈	猎,列,裂,劣	咧
乌	污,屋,呜,于,巫,恶,诬	武,芜,物,误,侮,勿,无,舞,五,吴,坞,梧,务,蜈,雾,晤,鹉,午,亡,捂,悟,伍
爹		蝶,碟,叠,谍,跌
狼	廊,琅,郎,榔	朗,浪
狭	侠,辖,暇,斜,匣,挟,峡,霞,洽	下,夏,虾,吓,厦,瞎
狈	辈,备,贝,背,惫,焙,臂,倍,被	北,杯,卑,碑,悲
狸	丽,璃,厘,离,漓,篱,梨,犁,黎	立,砾,痢,俐,鲤,沥,哩,隶,励,粒,李,里,厉,雳,历,荔,栗,利,力,理,莉,例,吏,礼
班	扳,颁,搬,般,斑	版,伴,办,板,拌,半,瓣,绊,扮
琉	留,瘤,刘,流,榴,硫,泵	馏,陆,铆,柳,溜,六
珠	蛛,诸,朱,株,猪	柱,轴,蛀,逐,注,住,煮,驻,主,竹,属,烛,嘱,拄,铸,术,助,祝,贮,筑
畔	叛,判,盼	盘,潘,般,胖,攀
亩	姥,拇,牡,母,姆	沐,牧,幕,募,慕,睦,穆,暮,模,目,墓,木
畜	处,触,叙,絮,旭,绪,酗,婿,蓄,续,恤,序,矗	厨,徐,橱,许,需,初,锄,吁,础,雏,楚,须,出,储,除,虚
留	瘤,刘,流,榴,琉,硫,泵	馏,陆,铆,柳,溜,六
疾	吉,极,借,及,吃,脊,唧,即,急,圾,级,寂,集,辑,嫉,击,棘,籍	技,几,箕,其,稽,祭,冀,鸡,际,居,肌,寄,系,剂,继,机,忌,叽,讥,期,季,激,饥,记,济,绩,纪,妓,荠,计,积,既,基,己,鲫,骑,奇,挤,畸,迹,给
病	并	屏,丙,冰,禀,饼,秉,柄,兵
症	怔,正,狰,睁,争,丁,政,郑,证,征,筝,挣,蒸	怔,蒸,拯,狰,睁,争,丁,政,郑,整,征,筝,证
疲	皮,脾,罢,啤	坏,霹,譬,否,僻,批,辟,屁,劈,被,匹,披
疼	誊,腾	
疹	枕,诊	侦,真,珍,阵,贞,榛,斟,震,针,镇,振
益	掖,衣,忆,溢,肄,易,屹,一,亿,意,艺,邑,义,绎,议,毅,亦,译,逸,翼,奕,液,役,谊,艾,腋,抑,疫,异	已,乙,疑,倚,医,揖,夷,移,矣,遗,宜,尾,椅,蛇,漪,姨,壹,以,依,胰,仪,伊,蚁
真	侦,诊,珍,贞,榛,斟,针	疹,枕,阵,镇,震,振
眠	棉,绵	冕,免,面,勉,缅,娩
眨	渣	炸,乍,闸,喳,查,诈,扎,栅
矩	举,沮	拒,足,聚,剧,炬,居,锯,句,巨,具,拘,惧,菊,蛆,俱,据,橘,车,鞠,驹,局,距
砰	烹,澎	捧,碰,蓬,彭,棚,硼,朋,篷,膨,鹏
砸	杂,咱	
破	迫,泊,魄,朴	坡,颇,婆,波,剖,泼
祠	词,雌,磁,辞,慈,瓷	此,伺,刺,次,差,赐,厕
祟	穗,碎,遂,隧,岁	髓,随,虽
祖	组,阻,诅	族,足,卒,租
神	甚	肾,身,深,绅,呻,信,渗,伸,沈,审,婶,参,申,慎
祝	柱,蛀,注,住,驻,铸,助	轴,逐,猪,煮,蛛,主,竹,诸,属,烛,嘱,朱,拄,株,术,珠,贮,筑
秤	称	澄,呈,橙,逞,惩,承,成,程,乘,撑,城,盛,诚
秧	央,鸯,殃	养,阳,氧,扬,样,羊,漾,仰,洋,杨,痒
租		族,组,足,阻,诅,卒,祖
秦	禽,勤,芹,擒,琴	亲,寝,侵,钦
秩	质,知,挚,识,窒,制,帜,志,智,治,置,滞,稚,致,至	植,汁,蜘,织,吱,旨,直,值,芝,枝,职,殖,只,之,趾,指,止,纸,脂,氏,执,支,肢,掷,址,征
秘	密,蜜,觅,泌	咪,谜,弥,糜,迷,靡,米
窄	贼,则,择,泽,责	寨,怎,债,宅,摘,祭,斋,侧,齐
站	占,战,颤,暂,蘸,栈,绽	毡,斩,盏,展,崭,瞻,沾
笆	捌,扒,芭,巴,叭,八,疤,吧	爸,坝,耙,靶,罢,霸,跋,伯,拔,把
笑	啸,酵,校,孝,效,肖	哮,小,销,萧,嚣,削,硝,宵,箫,学,消,晓
粉		份,吩,忿,奋,粪,芬,纷,分,愤,焚,坟,氛
纺	仿,访	妨,坊,房,防,芳,方,放,肪
纱	沙,煞,杀,砂,杉	厦,霎,傻
纹	闻,文,蚊	紊,问,瘟,免,温,吻,稳
紊	闻,文,问,免	纹,瘟,蚊,温,吻,稳
素	肃,速,宿,诉,溯,塑,缩,粟	酥,俗,苏
索	所,琐,锁	嗦,缩,唆,梭
纯	唇,醇,淳	蠢,春
纽	钮,扭	牛,拗
级	吉,极,借,及,吃,脊,唧,即,急,圾,寂,集,辑,嫉,击,疾,棘,籍	技,几,箕,其,稽,祭,冀,鸡,际,居,肌,寄,系,剂,继,机,忌,叽,讥,期,季,激,饥,记,济,绩,纪,妓,荠,计,积,既,基,己,鲫,骑,奇,挤,畸,迹,给
纳	那,娜,钠,捺,呐	拿,哪
纸	指,止,旨,只,址,趾,征	植,汁,蜘,织,吱,知,直,值,置,芝,滞,治,枝,至,职,秩,殖,帜,只,之,智,致,识,质,挚,窒,脂,稚,氏,执,支,肢,掷,制,志
纷	芬,吩,分,氛	份,忿,奋,粪,粉,愤,焚,坟
缺		确,壳,鹊,雀,瘸,却,怯
羔	高,糕,篙,膏	搅,搞,告,稿
翅	赤,斥	吃,池,嗤,持,齿,侈,耻,迟,驰,匙,尺,弛
翁	嗡	
耘	云,匀	蕴,运,韵,陨,员,酝,孕,允,晕
耕	更,羹	梗,耿,埂
耙	爸,扒,坝,爬,罢,霸,伯	捌,芭,笆,拔,帕,巴,靶,叭,八,趴,疤,跋,怕,吧,把
耗	镐,浩,好,号	嚎,壕,豪,毫,鹤,蒿
耽	丹,担,单	石,淡,蛋,但,旦,诞,弹,氮,胆
耿	梗,埂	更,羹,耕
脂	吱,汁,蜘,织,支,肢,知,只,之,芝,枝,氏	植,旨,直,值,置,滞,治,至,职,秩,殖,帜,智,趾,致,识,指,质,止,挚,窒,纸,稚,执,掷,制,址,志,征
胰	谊,蛇,仪,夷,移,遗,姨,疑,宜,一	掖,已,乙,衣,忆,溢,易,肄,倚,屹,亿,意,艺,议,邑,义,医,绎,揖,毅,矣,亦,译,益,尾,椅,逸,翼,漪,奕,液,役,壹,以,依,艾,伊,蚁,抑,疫,异,腋
胁	谐,协,邪,斜,鞋,挟,携	泻,卸,懈,屉,械,蟹,谢,楔,些,屑,写,血,契,骇,歇,解
脆	翠,粹,悴	催,摧,衰,崔
胸	汹,凶,兄,匈	熊,雄
胳	戈,搁,鸽,疙,割,哥,歌	个,格,葛,阁,合,各,隔,革,蛤
脉	墨,末,寞,默,沫,莫,磨,卖,膜,麦,没,迈,漠,茉,陌	么,蘑,摸,摹,魔,抹,摩,模,埋,买
能		泞
脊	吉,吃,即,几,圾,集,嫉,籍,借,级,寂,击,极,唧,济,辑,疾,及,己,急,挤,棘,给	技,箕,其,稽,祭,冀,鸡,际,居,肌,寄,系,剂,继,机,忌,叽,讥,期,季,激,饥,记,绩,纪,妓,计,积,既,基,鲫,骑,奇,畸,迹,荠
胯	跨	夸,垮
臭	绣,宿,秀,锈,嗅,袖	休,酬,稠,羞,愁,丑,畴,筹,绸,仇,抽,朽,凑,修
舀	夭,咬	乐,哟,姚,腰,要,遥,谣,么,窑,钥,淆,吆,拗,摇,侥,耀,妖,肴,外,歪,邀,药
航	吭,杭,行	
般	班,盘,扳,播,拨,搬,剥,颁,玻,胖,斑,菠	版,舶,驳,伴,办,渤,叛,柏,勃,畔,扮,跛,膊,潘,半,荸,卜,瓣,绊,博,薄,脖,泊,盼,攀,伯,白,簸,搏,板,判,拌
茫	盲,芒,忙,氓	莽
荒	慌	晃,惶,恍,谎,皇,凰,黄,幌,蝗,煌
荔	利,立,粒,隶,丽,砾,力,痢,莉,厉,例,俐,雳,吏,历,励,沥,栗	哩,李,里,理,厘,璃,离,漓,篱,梨,犁,礼,狸,鲤,黎
荆	精,京,兢,晶,鲸,更,睛,惊,经,茎	径,境,竞,静,劲,净,警,靖,颈,阱,景,敬,镜,井,竟
茸	蓉,绒,融,冗,熔,容,榕,溶,荣	
荐	舰,健,箭,剑,溅,见,件,贱,渐,键,监,践,间,建,涧,鉴	碱,肩,俭,茧,歼,艰,煎,奸,拣,减,剪,检,简,坚,兼,捡,尖,柬
草		糙,操,槽,曹
茵	因,姻,音,殷,阴	隐,银,瘾,淫,引,吟,印,听,蚓,饮
茴	蛔,回	慧,绘,惠,悔,灰,贿,讳,恢,毁,晦,辉,徽,诲,会,溃,汇,秽,挥,虫,堕
茶	查,察	插,叉,刹,差,喳,岔
蚊	闻,文,纹	紊,问,瘟,免,温,吻,稳
蚪	抖,斗,陡	兜,豆,读,逗,都,痘,斗
蚓	隐,瘾,引,听,饮	因,姻,音,银,淫,吟,殷,印,茵,阴
蚤	藻,澡,早,枣	糟,躁,凿,造,噪,灶,燥,遭,皂
蚌	傍,磅,棒,谤,旁	膀,梆,邦,帮,榜,绑
蚣	功,宫,共,红,攻,弓,恭,工,躬,供,公	贡,巩,汞,矿,拱
蚜	押,衙,涯,牙,芽	哑,压,雅,轧,讶,呀,鸦,亚,鸭
衰	催,摧,摔,崔	率,帅,翠,蟀,粹,甩,脆,悴
衷	终,忠,盅,中,钟	仲,种,重,众,肿
袁	援,缘,源,辕,猿,员,园,圆,原,元	宛,远,怨,愿,院,冤,渊,鸳
记	计,技,季,际,济,妓,纪,寄,系,鲫,剂,骑,继,忌,祭,冀,既,荠	吉,吃,即,几,圾,箕,其,稽,集,嫉,鸡,籍,借,脊,级,居,寂,肌,机,叽,击,讥,极,期,唧,激,饥,绩,辑,积,疾,基,及,己,急,奇,挤,畸,棘,迹,给
讨		涛,逃,桃,套,滔,陶,淘,萄,掏
讯	训,驯,汛,殉,逊,迅	寻,旬,巡,询,循,勋
训	讯,驯,汛,殉,逊,迅	寻,旬,巡,询,循,勋
岂	乞,楷,启,起,稽,凯,慨	开,揩,气,崎,鳍,柒,其,枝,戚,弃,溪,旗,脐,只,迄,器,泣,欺,祈,期,漆,砌,栖,企,歧,七,凄,妻,棋,骑,奇,咳,契,畦,汽,齐
豺	柴	拆,差
豹	爆,抱,暴,报,刨	胞,保,褒,雹,苞,宝,饱,包,堡,薄
财	才,材,裁	彩,踩,睬,猜,菜,采
贡	共,供	蚣,宫,功,巩,汞,红,攻,弓,矿,恭,工,躬,拱,公
起	乞,稽,启,岂	气,崎,鳍,其,柒,枝,戚,弃,溪,旗,脐,只,迄,器,泣,欺,祈,期,漆,砌,栖,企,歧,七,凄,妻,棋,骑,奇,契,畦,汽,齐
躬	蚣,功,宫,共,攻,红,弓,恭,工,供,公	贡,巩,汞,矿,拱
轩	喧,宣	悬,炫,还,漩,玄,县,选,旋
辱	入,乳,女,褥	儒,如,蠕
送	颂,讼,诵,宋	松,耸
逆	腻,匿,泥,溺	你,呢,拟,尼
迷	弥,谜,靡,糜	蜜,咪,泌,密,觅,秘,米
退	蜕	腿,颓,推
逃	涛,桃,陶,萄,淘	讨,套,滔,掏
追	锥,椎	坠,赘,缀
酒	韭,久,灸,九,玖,纠	旧,救,疚,鸠,臼,舅,究,就,揪
配	佩,沛	坏,胚,培,赔,陪
酌	茁,啄,琢,着,卓,灼,浊,拙	桌,捉
钉	盯,定,订,丁,锭,叮	鼎,顶,丁
针	侦,诊,真,珍,贞,榛,斟	疹,枕,阵,镇,震,振
闪	陕	善,删,山,赡,衫,扇,珊,擅,膳,杉,单
院	远,怨,愿	袁,援,宛,缘,源,猿,辕,员,园,渊,冤,圆,原,鸳,元
阵	镇,枕,震,振	疹,侦,诊,真,珍,贞,榛,斟,针
陡	蚪,斗,抖	兜,豆,读,逗,都,痘,斗
陕	闪	善,删,山,赡,衫,扇,珊,擅,膳,杉,单
除	厨,橱,锄,雏,储	处,触,初,础,楚,畜,出,矗
饥	期,唧,激,几,绩,箕,居,肌,讥,其,稽,奇,机,畸,积,鸡,迹,叽,基	吉,吃,技,即,圾,集,祭,冀,嫉,籍,借,脊,际,级,寂,寄,系,剂,继,忌,击,极,季,记,济,纪,妓,辑,计,疾,既,及,己,急,给,鲫,骑,挤,棘,荠
马	码,蚂,吗,玛	么,麻,妈,骂,蟆
骨	滑,凸,古,谷,股,鼓,贾	雇,沽,告,故,咕,固,估,顾,家,姑,孤,辜
高	糕,篙,膏,羔	搅,搞,告,稿
鬼	诡,轨	规,瑰,闺,龟,柜,贵,桂,归,傀,跪
伪	慰,胃,魏,尉,味,未,卫,位,喂,为,遗,谓,蔚,畏	危,薇,萎,威,唯,苇,违,委,偎,围,微,伟,桅,巍,维,纬,尾
停	亭,廷,庭,蜓	听,厅,挺,艇
假	夏,稼,价,驾,架,甲,钾,嫁,贾	夹,佳,茄,挟,嘉,加,荚,家,颊
做	作,坐,座,凿	昨,左
伟	萎,苇,委,纬,尾	威,谓,巍,魏,味,未,围,喂,遗,畏,胃,薇,位,为,微,伪,桅,维,偎,慰,尉,唯,卫,违,蔚,危
健	舰,箭,荐,剑,溅,见,件,贱,渐,键,监,践,间,建,涧,鉴	碱,肩,俭,茧,歼,艰,煎,奸,拣,减,剪,检,简,坚,兼,捡,尖,柬
偶	呕,藕	鸥,殴,欧,区
偎	萎,威,委	谓,巍,魏,味,未,围,喂,遗,畏,伟,尾,胃,薇,位,为,微,伪,桅,维,纬,慰,尉,唯,卫,违,苇,蔚,危
侦	诊,真,珍,贞,榛,斟,针	疹,枕,阵,镇,震,振
侧	测,厕,策,册	贼,则,怎,择,泽,窄,责
偷		头,投,透
偏	扁,翩,篇	骗,遍,片,便
兜	都	蚪,豆,抖,读,陡,逗,痘,斗
冕	缅,免,勉,娩	棉,绵,面,眠
凰	惶,皇,黄,蝗,煌	恍,谎,幌,慌,晃,荒
剪	碱,茧,拣,减,检,简,俭,捡,柬	箭,见,建,歼,艰,煎,件,贱,键,践,鉴,舰,肩,渐,监,间,坚,尖,健,荐,剑,奸,涧,溅,兼
副	父,赋,复,附,咐,负,赴,富,妇,傅,腹,付	甫,辐,符,麸,缚,服,扶,辅,夫,孵,肤,福,俘,浮,蝠,抚,幅,斧,腐,芙,袱,拂,脯,府,俯,敷,伏
勒	肋,乐,垃	雷,垒,擂,泪,累,了,类,蕾,儡
务	晤,误,坞,勿,恶,悟,雾,物	屋,武,于,芜,污,侮,呜,无,舞,五,吴,乌,梧,蜈,鹉,午,巫,亡,捂,诬,伍
勘	看,堪,刊	坎,砍
动	洞,冻,栋	董,东,懂,冬
匙	池,持,迟,驰,弛	拾,吃,石,恃,提,失,射,誓,侍,适,斥,虱,饰,嗜,士,始,十,式,拭,屎,事,示,嗤,齿,室,尸,释,识,市,使,矢,耻,什,世,驶,势,实,史,食,硕,尺,是,师,湿,氏,视,侈,翅,蚀,狮,诗,赤,柿,逝,时,施,试
匿	腻,泥,逆,溺	你,呢,拟,尼
区	圈,岖,蛆,趋,殴,欧,呕,驱,鸥,曲,躯,屈	取,漆,藕,偶,渠,娶,趣,去
匾	扁,贬	蝙,边,变,便,辩,辫,辨,编,鞭,遍
参	绅,身,深,信,呻,伸,餐,三,申	肾,神,蚕,渗,残,沈,审,惨,婶,散,灿,伞,惭,甚,慎
曼	慢,蔓,漫,幔	满,瞒,蛮,馒
商	伤,汤	赏,裳,晌,上,尚
啦	喇,拉	辣,落,腊,蜡
啄	茁,酌,琢,着,卓,灼,浊,拙	桌,捉
哑	噩,雅,遏,俄,恶,饿,愕,亚,鳄,扼	押,压,阿,衙,涯,轧,讶,呀,讹,鸦,蚜,牙,额,蛾,鹅,芽,鸭
啡	菲,非,飞	费,沸,肺,废,匪,诽,肥,吠
啃	肯,垦,恳	
啊	阿	
唱	畅,倡	尝,长,猖,裳,肠,厂,敞,场,常,偿,昌
问	闻,紊,文,免	纹,瘟,蚊,温,吻,稳
唯	薇,违,围,为,微,桅,巍,维,危	威,委,谓,魏,味,未,喂,遗,畏,伟,尾,胃,位,伪,偎,纬,慰,尉,萎,卫,苇,蔚
啤	皮,疲,脾,罢	坏,霹,譬,否,僻,批,辟,屁,劈,被,匹,披
售	寿,瘦,授,受,兽	熟,手,首,守,收
唬	许,虎	糊,壶,胡,护,乎,蝴,葫,沪,忽,湖,互,狐,呼,户,戏,弧
圈	身,绢,鹃,岖,蛆,卷,趋,眷,驱,区,捐,曲,倦,躯,屈	取,全,漆,券,权,渠,娶,拳,趣,痊,泉,犬,去,劝
国		裹,果,锅,过,郭
域	狱,预,语,欲,玉,御,愈,吁,豫,喻,寓,誉,郁,浴,裕,育,尉,谷,芋,与,遇	隅,羽,雨,屿,宇,愉,于,迂,鱼,愚,予,榆,逾,淤,渔,娱,舆
坚	肩,歼,艰,煎,奸,渐,监,间,溅,兼,尖	箭,见,拣,减,剪,建,捡,件,贱,键,践,鉴,俭,碱,舰,茧,检,简,柬,健,荐,剑,涧
堆		队,醉,兑,嘴,最,罪,对
埠	怖,部,步,不,布,簿	补,捕,卜,哺
基	期,唧,激,饥,几,绩,箕,居,肌,其,稽,奇,机,畸,积,鸡,迹,叽,讥	吉,吃,技,即,圾,集,祭,冀,嫉,籍,借,脊,际,级,寂,寄,系,剂,继,忌,击,极,季,记,济,纪,妓,辑,计,疾,既,及,己,急,给,鲫,骑,挤,棘,荠
堂	塘,膛,搪,糖,唐,棠	烫,淌,汤,趟,倘,躺
堵	睹,赌,肚	妒,牍,读,渡,毒,督,都,度,镀,杜,独
执	植,质,职,掷,殖,直,值	吱,汁,蜘,织,知,旨,置,芝,滞,治,枝,至,秩,只,帜,之,智,趾,致,识,指,止,挚,窒,纸,脂,稚,氏,支,肢,制,址,志,征
培	赔,陪	坏,配,胚,佩,沛
够	购,构,垢	苟,沟,狗,句,勾,钩
奢	赊	社,蛇,拾,叶,设,舍,什,射,涉,摄,舌,甚,赦
娶	取,漆,趣,去,曲	圈,岖,蛆,趋,渠,驱,区,躯,屈
娄	缕,旅,铝,侣,吕,楼,履,屡	虑,滤,率,漏,氯,绿,搂,驴,篓,律,陋,露
婉	宛,挽,碗,晚,娩	弯,惋,丸,完,顽,万,腕,湾,豌,玩
妇	父,赋,复,附,咐,负,副,富,赴,腹,傅,付	甫,辐,符,麸,缚,服,扶,辅,夫,孵,肤,福,俘,浮,蝠,抚,幅,斧,腐,芙,袱,拂,脯,府,俯,敷,伏
婚	荤,昏	浑,魂,混
婆		迫,坡,魄,破,颇,泊,朴,波,剖,泼
寇	扣	口
寄	计,技,季,际,记,济,妓,纪,系,鲫,剂,骑,继,忌,祭,冀,既,荠	吉,吃,即,几,圾,箕,其,稽,集,嫉,鸡,籍,借,脊,级,居,寂,肌,机,叽,击,讥,极,期,唧,激,饥,绩,辑,积,疾,基,及,己,急,奇,挤,畸,棘,迹,给
寂	吉,极,借,及,吃,脊,唧,即,急,圾,级,集,辑,嫉,击,疾,棘,籍	技,几,箕,其,稽,祭,冀,鸡,际,居,肌,寄,系,剂,继,机,忌,叽,讥,期,季,激,饥,记,济,绩,纪,妓,荠,计,积,既,基,己,鲫,骑,奇,挤,畸,迹,给
宿	肃,绣,臭,速,粟,素,诉,溯,秀,锈,朽,缩,嗅,塑,袖	休,酥,羞,俗,修,苏
密	蜜,秘,觅,泌	咪,谜,弥,糜,迷,靡,米
尉	狱,预,语,欲,谓,玉,御,吁,愈,豫,魏,味,喻,未,寓,喂,遗,誉,畏,郁,胃,浴,域,裕,位,为,伪,慰,育,卫,谷,芋,与,蔚,遇	隅,雨,屿,威,于,委,鱼,予,舆,巍,羽,围,渔,伟,尾,薇,迂,愚,微,淤,维,桅,偎,纬,宇,愉,萎,唯,苇,违,榆,逾,娱,危
专	砖	传,撰,转,赚
将	呛,酱,浆,抢,强,降,枪,匠,僵,疆,腔,姜,江,缰	奖,墙,桨,蒋,讲
屠	凸,涂,图,途,突,徒	秃,土,吐,兔
屉	剃,泻,解,卸,懈,谢,蟹,械,楔,屑,契,骇,涕,替,惕	提,写,体,谐,些,梯,携,协,斜,胁,踢,剔,歇,堤,邪,鞋,血,挟,题,蹄,啼
崇	重,虫	充,冲,宠
崎	祈,期,旗,棋,只,脐,骑,鳍,奇,其,歧,畦,枝,齐	气,启,起,柒,稽,戚,弃,溪,迄,器,泣,欺,漆,砌,乞,栖,七,凄,妻,契,汽,岂,企
崩	绷	蹦
崔	催,摧,衰	脆,翠,粹,悴
岗	肛,刚,港,纲,钢,冈,扛,缸	
巢	潮,嘲,朝	钞,炒,抄,吵,超,剿
常	尝,长,裳,肠,场,偿	畅,唱,猖,厂,敞,倡,昌
带	逮,待,大,代,怠,贷,袋,戴	呆,歹
帐	胀,丈,长,杖,涨,障,仗,账	樟,掌,张,彰,章
康	慷,糠	炕,抗,扛
庸	拥,佣	咏,踊,蛹,用,泳,勇,永,佣
庶	述,竖,漱,数,束,曙,恕,署,树,墅,术,疏	鼠,薯,抒,枢,熟,蜀,梳,暑,书,叔,淑,属,舒,蔬,赎,殊,输,黍
庵	氨,鞍,安	按,岸,俺,暗,案
张	彰,樟,章	胀,丈,掌,长,杖,涨,障,帐,仗,账
强	将,墙,抢,酱,降,匠	奖,呛,桨,浆,蒋,枪,僵,疆,腔,姜,江,讲,缰
彬	濒,缤,滨,宾	鬓
彩	采,踩,睬	材,裁,猜,财,菜,才
得	的,德	
徙	喜,洗	息,希,习,吸,行,席,溪,锡,稀,隙,牺,系,膝,熙,犀,携,媳,戏,熄,西,悉,晰,惜,栖,嬉,蟋,厘,析,昔,细,夕,畦,袭
从	囱,匆,综,聪,纵,葱,丛	总,踪,棕,宗
徘	排,牌	拍,派,湃
御	狱,预,语,欲,玉,愈,吁,豫,喻,寓,誉,郁,域,浴,裕,育,尉,谷,芋,与,遇	隅,羽,雨,屿,宇,愉,于,迂,鱼,愚,予,榆,逾,淤,渔,娱,舆
患	焕,痪,幻,涣,唤,宦,换	环,还,缓,欢
悉	西,溪,希,晰,厘,析,稀,栖,牺,嬉,膝,熙,犀,吸,蟋,行,携,畦	席,息,习,昔,锡,喜,惜,细,夕,隙,系,徙,熄,媳,袭,洗,戏
悠	优,忧,幽	佑,又,由,犹,油,幼,右,游,诱,邮,尤,有,友
惋	万,腕,玩	弯,宛,挽,婉,碗,丸,完,顽,湾,晚,豌,娩
悴	脆,翠,粹	催,摧,衰,崔
惦	佃,淀,殿,电,店,垫,奠,玷,甸	颠,碘,典,点
情	请,晴,擎,倾	顷,青,蜻,亲,卿,氢,庆,轻,清,请
惜	席,息,习,锡,昔,媳,袭,熄	希,吸,行,溪,稀,隙,牺,系,膝,熙,犀,携,戏,洗,西,悉,晰,喜,栖,嬉,蟋,厘,析,细,夕,徙,畦
悼	蹈,导,到,盗,倒,道,稻	祷,岛,叨,捣,刀
惕	屉,剃,替,涕	堤,题,提,体,梯,踢,剔,蹄,啼
戚	溪,凄,漆,妻,栖,柒,七,欺	气,启,起,鳍,稽,其,崎,枝,弃,旗,脐,只,迄,器,泣,祈,期,乞,砌,歧,齐,棋,骑,奇,契,畦,汽,岂,企
掠	略	
控	空	恐,孔
掖	衣,忆,溢,肄,易,屹,一,亿,意,艺,邑,义,绎,议,毅,亦,译,益,逸,翼,奕,液,役,谊,艾,腋,抑,疫,异	已,乙,疑,倚,医,揖,夷,移,矣,遗,宜,尾,椅,蛇,漪,姨,壹,以,依,胰,仪,伊,蚁
探	叹,瘫,贪,滩,摊,碳,炭	谈,坦,昙,袒,潭,痰,坛,谭,弹,檀,毯
接	街,结,揭,皆,阶	借,界,诫,洁,劫,捷,姊,姐,介,截,戒,竭,芥,杰,届,节,解
捷	结,洁,劫,截,竭,杰,节	借,界,街,诫,揭,皆,阶,解,介,芥,接,姊,届,戒,姐
捧		碰,澎,蓬,彭,烹,棚,砰,硼,朋,篷,膨,鹏
掘	诀,倔,觉,嚼,角,绝,脚,决,爵	
措	挫,撮,错,锉	搓
掩	演,眼,衍	咽,艳,盐,炎,堰,延,癌,颜,沿,砚,阎,焰,奄,殷,雁,验,宴,燕,严,烟,研,厌,谚,言,唁,淹
掉	吊,调,钓	叼,雕,碉,刁
扫	嫂	骚,艘,搔
推		蜕,腿,颓,退
抡	论,轮,沦,仑,伦	
授	寿,瘦,售,受,兽	熟,手,首,守,收
挣	怔,正,狰,睁,争,丁,政,郑,证,征,症,筝,蒸	整,拯,丁
排	徘,牌	拍,派,湃
掏	涛,滔	逃,桃,套,讨,萄,陶,淘
掀	纤,鲜,仙,先	宪,闲,嫌,现,限,陷,咸,线,铣,弦,显,馅,癣,险,腺,衔,县,献,贤,涎,舷
捻	撵,碾	念,年
捺	那,娜,钠,纳,呐	拿,哪
救	旧,疚,臼,舅,究,就	酒,韭,鸠,久,灸,九,揪,玖,纠
教	窖,蕉,叫,焦,觉,椒,骄,交,校,郊,礁,浇,轿,胶,较,娇	搅,缴,狡,矫,嚼,角,绞,脚,剿,饺,侥
败	拜	百,白,摆
启	起,乞,稽,岂	气,崎,鳍,其,柒,枝,戚,弃,溪,旗,脐,只,迄,器,泣,欺,祈,期,漆,砌,栖,企,歧,七,凄,妻,棋,骑,奇,契,畦,汽,齐
敏	皿,悯,闽	民
叙	絮,旭,绪,酗,婿,蓄,续,畜,恤,序	徐,吁,需,须,许,虚
斜	侠,谐,协,辖,邪,暇,狭,鞋,匣,胁,挟,携,峡,霞,洽	下,泻,楔,写,厦,解,骇,卸,些,谢,虾,蟹,吓,械,屑,歇,瞎,夏,懈,屉,血,契
斩	盏,崭,展	占,毡,站,战,颤,暂,瞻,蘸,栈,沾,绽
族	足,卒	组,阻,诅,租,祖
旋	悬,炫,还,漩,玄,县	选,喧,轩,宣
昼	咒,皱,宙	轴,洲,州,周,舟,帚,肘,粥
晚	宛,挽,婉,碗,娩	弯,惋,丸,完,顽,万,腕,湾,豌,玩
晤	误,坞,勿,务,恶,悟,雾,物	屋,武,于,芜,污,侮,呜,无,舞,五,吴,乌,梧,蜈,鹉,午,巫,亡,捂,诬,伍
晨	陈,尘,忱,沈,臣,沉,辰	趁,称,衬
晦	慧,惠,绘,讳,诲,会,汇,秽,贿,溃	悔,灰,恢,毁,辉,茴,徽,回,蛔,挥,虫,堕
曹	槽	草,糙,操
望	忘,旺,王,妄	往,汪,枉,亡,网
梁	粮,良,凉,粱,量	晾,俩,两,亮,谅,辆
梯	剔,踢	剃,堤,屉,提,体,啼,题,涕,替,蹄,惕
梢	稍,烧,捎	芍,勺,哨,少,绍,召
桶	统,筒	桐,通,彤,痛,童,瞳,同,铜
梧	无,巫,亡,蜈,吴,诬,芜	屋,武,于,物,误,污,侮,勿,呜,舞,五,乌,坞,务,雾,晤,鹉,午,捂,恶,悟,伍
梗	耿,埂	更,羹,耕
械	泻,卸,懈,屉,蟹,谢,楔,屑,契,骇,解	谐,协,邪,斜,些,鞋,血,胁,写,挟,携,歇
弃	气,妻,砌,迄,汽,契,器,泣,企	启,起,鳍,稽,柒,其,崎,枝,戚,溪,旗,脐,只,欺,祈,期,漆,乞,栖,歧,七,凄,棋,骑,奇,畦,岂,齐
梭	嗦,缩,唆	所,琐,锁,索
梆	傍,帮,邦	膀,蚌,磅,榜,棒,旁,绑,谤
梅	眉,霉,媒,楣,没,枚,煤,玫	媚,每,美,昧,妹
条	调	跳,挑
梨	丽,璃,厘,离,漓,篱,犁,狸,黎	立,砾,痢,俐,鲤,沥,哩,隶,励,粒,李,里,厉,雳,历,荔,栗,利,力,理,莉,例,吏,礼
欲	狱,预,语,玉,御,愈,吁,豫,喻,寓,誉,郁,浴,域,裕,育,尉,谷,芋,与,遇	隅,羽,雨,屿,宇,愉,于,迂,鱼,愚,予,榆,逾,淤,渔,娱,舆
杀	晒,沙,煞,砂,纱,杉	厦,霎,筛,傻
毫	嚎,壕,豪,号,鹤	镐,耗,浩,好,蒿
氢	顷,青,蜻,卿,轻,清,倾	晴,亲,庆,情,请,擎
涎	贤,闲,嫌,衔,弦,舷,咸	腺,宪,馅,先,掀,现,铣,鲜,纤,癣,限,显,县,陷,仙,献,险,线
凉	晾,粮,良,粱,亮,量,谅,辆,梁	俩,两
淳	唇,纯,醇	蠢,春
液	掖,衣,忆,溢,肄,易,屹,一,亿,意,艺,邑,义,绎,议,毅,亦,译,益,逸,翼,奕,役,谊,艾,腋,抑,疫,异	已,乙,疑,倚,医,揖,夷,移,矣,遗,宜,尾,椅,蛇,漪,姨,壹,以,依,胰,仪,伊,蚁
淡	石,旦,蛋,但,诞,担,弹,氮	丹,耽,胆,单
淌	倘,躺	烫,塘,膛,搪,汤,趟,堂,糖,唐,棠
淤	迂	狱,隅,雨,屿,预,语,于,欲,鱼,予,玉,御,吁,舆,愈,豫,羽,喻,寓,渔,誉,郁,浴,域,裕,愚,育,宇,尉,愉,谷,芋,榆,逾,与,娱,遇
添	天	甜,恬,田,填,舔
浅	遣,谴	钱,铅,千,钳,嵌,迁,黔,纤,歉,牵,谦,签,欠,干,潜,前
清	顷,青,蜻,卿,轻,氢,倾	晴,亲,庆,情,请,擎
淋	磷,邻,琳,鳞,林,临	凛,赁,吝,躏
涯	押,衙,蚜,牙,芽	哑,压,雅,轧,讶,呀,鸦,亚,鸭
淑	熟,叔,赎	鼠,蜀,树,述,梳,暑,束,恕,蔬,输,黍,疏,薯,竖,抒,书,曙,属,墅,术,庶,枢,漱,数,署,舒,殊
涮		栓,拴
淹	唁,燕,烟,咽,焰,奄,殷,艳,研,沿,谚,厌,雁,砚,验,堰,宴	延,癌,掩,阎,严,衍,眼,演,颜,盐,炎,言
混	浑,魂	婚,荤,昏
渊	宛,鸳,冤	援,远,怨,缘,愿,源,辕,猿,院,员,园,袁,圆,原,元
凄	溪,漆,妻,栖,柒,七,戚,欺	气,启,起,鳍,稽,其,崎,枝,弃,旗,脐,只,迄,器,泣,祈,期,乞,砌,歧,齐,棋,骑,奇,契,畦,汽,岂,企
涵	韩,函,含,汗,寒	悍,喊,罕,焊,汉,翰,憾,酣,旱,撼,和,捍
泪	擂,类,累	垒,勒,雷,蕾,儡
淫	吟,银	因,隐,姻,音,瘾,引,殷,印,听,蚓,茵,阴,饮
淘	涛,逃,桃,陶,萄	讨,套,滔,掏
沦	论,轮,抡,仑,伦	
深	绅,身,信,呻,伸,参,申	肾,神,渗,审,沈,婶,甚,慎
淮	徊,怀,槐	坏
净	径,境,竞,静,劲,靖,敬,镜,竟	精,京,兢,晶,鲸,警,颈,更,阱,景,睛,荆,惊,经,井,茎
淆	遥,谣,窑,姚,肴,摇,侥	邀,乐,咬,么,哟,舀,吆,钥,拗,耀,妖,夭,腰,药,要
烹	澎,砰	捧,碰,蓬,彭,棚,硼,朋,篷,膨,鹏
焊	悍,汉,翰,憾,旱,撼,汗,捍	韩,喊,罕,函,酣,含,寒,和,涵
爽		霜,双
牵	铅,千,嵌,迁,纤,谦,签	浅,钱,遣,谴,钳,黔,歉,欠,干,潜,前
犁	丽,璃,厘,离,漓,篱,梨,狸,黎	立,砾,痢,俐,鲤,沥,哩,隶,励,粒,李,里,厉,雳,历,荔,栗,利,力,理,莉,例,吏,礼
猜		彩,踩,材,睬,裁,财,菜,才,采
猛	锰	孟,蒙,盟,朦,梦,檬,萌
猖	倡,昌	畅,唱,尝,长,裳,肠,厂,敞,场,常,偿
狰	怔,正,争,睁,丁,征,症,筝,挣,蒸	拯,政,郑,症,整,证
率	虑,滤,帅,蟀,数,烁,勺,绿,氯,硕,律	缕,旅,铝,衰,侣,吕,驴,甩,屡,摔,履,说,娄
琅	廊,狼,郎,榔	朗,浪
球	囚,求,仇	丘,秋,龟,蚯
理	哩,李,里,礼,鲤	立,砾,璃,痢,俐,狸,沥,隶,离,犁,励,粒,丽,厉,梨,雳,篱,历,荔,栗,利,力,厘,莉,漓,例,吏,黎
现	腺,宪,限,馅,县,陷,献,线	贤,险,先,闲,涎,掀,嫌,铣,鲜,衔,弦,纤,舷,显,癣,仙,咸
瓶	屏,冯,坪,凭,苹,平,评,萍	乒
瓷	词,雌,磁,辞,慈,祠	此,伺,刺,次,差,赐,厕
甜	恬,田,填	添,舔,天
产	阐,铲	缠,搀,馋,掺,单,蝉
略	掠	
畦	希,崎,鳍,其,吸,行,枝,溪,旗,稀,只,脐,牺,膝,熙,犀,携,西,悉,祈,晰,期,栖,嬉,歧,蟋,厘,析,棋,骑,奇,齐	息,气,习,启,起,柒,稽,戚,席,弃,锡,隙,系,迄,器,泣,媳,戏,熄,欺,洗,漆,砌,惜,喜,乞,七,凄,昔,妻,细,夕,徙,契,汽,岂,袭,企
毕	闭,币,毙,蔽,碧,泌,比,避,璧,壁,弊,臂,辟,庇,鄙,必	笔,彼,逼,匕,鼻
异	掖,衣,忆,溢,肄,易,屹,一,亿,意,艺,邑,义,绎,议,毅,亦,译,益,逸,翼,奕,液,役,谊,艾,腋,抑,疫	已,乙,疑,倚,医,揖,夷,移,矣,遗,宜,尾,椅,蛇,漪,姨,壹,以,依,胰,仪,伊,蚁
疏	述,抒,竖,枢,漱,数,梳,书,曙,束,恕,署,树,墅,蔬,舒,术,殊,输,庶	鼠,薯,熟,蜀,暑,叔,淑,属,赎,黍
痕		狠,很,恨
痊	卷,全,权,拳,泉,犬	圈,券,劝
盔	亏,窥	愧,葵,魁,傀,溃
盒	何,禾,核,荷,合,褐,盖,和,河	喝,呵,吓,赫,贺,鹤
盛	乘,澄,胜,呈,橙,惩,承,成,程,剩,圣,城,诚	生,升,绳,逞,称,声,秤,甥,牲,撑,省,笙
眷	圈,绢,倦,卷	捐,鹃,身
众	种,重,中,仲	终,忠,衷,肿,盅,钟
眼	演,掩,衍	咽,艳,盐,炎,堰,延,癌,颜,沿,砚,阎,焰,奄,殷,雁,验,宴,燕,严,烟,研,厌,谚,言,唁,淹
眶	框,矿,况,旷	筐,狂
硫	留,瘤,刘,流,榴,琉,泵	馏,陆,铆,柳,溜,六
祥	降,翔,详	响,向,镶,箱,享,乡,想,厢,相,像,巷,橡,香,湘,项,象
票	漂	飘,瓢
祭	技,冀,责,际,债,寄,系,剂,继,忌,季,记,济,妓,纪,计,既,寨,鲫,骑,荠	吉,吃,即,几,圾,箕,摘,其,稽,集,嫉,鸡,斋,籍,借,脊,级,居,寂,宅,肌,机,叽,击,讥,极,期,唧,激,饥,绩,辑,积,疾,基,及,己,急,给,奇,挤,窄,畸,棘,迹,齐
移	谊,蛇,胰,仪,夷,遗,姨,疑,宜,一	掖,已,乙,衣,忆,溢,易,肄,倚,屹,亿,意,艺,议,邑,义,医,绎,揖,毅,矣,亦,译,益,尾,椅,逸,翼,漪,奕,液,役,壹,以,依,艾,伊,蚁,抑,疫,异,腋
窒	质,知,挚,识,秩,制,帜,志,智,治,置,滞,稚,致,至	植,汁,蜘,织,吱,旨,直,值,芝,枝,职,殖,只,之,趾,指,止,纸,脂,氏,执,支,肢,掷,址,征
笨		本,奔
笛	涤,嘀,嫡,的,芽,敌	低,缔,抵,第,蒂,帝,地,滴,递,底,弟
第	缔,的,蒂,帝,地,递,弟	涤,嘀,嫡,低,滴,抵,笛,芽,底,敌
符	袱,幅,拂,福,辐,俘,服,浮,蝠,缚,扶,夫,伏,芙	甫,复,麸,负,咐,腹,妇,辅,孵,父,肤,赋,附,付,抚,斧,赴,腐,脯,府,俯,敷,富,傅,副
笙	生,胜,升,声,甥,牲	绳,剩,乘,圣,省,盛
粒	利,立,隶,力,丽,砾,痢,莉,厉,例,俐,雳,吏,历,励,沥,荔,栗	哩,李,里,理,厘,璃,离,漓,篱,梨,犁,礼,狸,鲤,黎
粗		趋,促,醋,错,趣,簇,卒
绊	伴,办,拌,半,瓣,扮	版,班,板,扳,颁,搬,般,斑
统	桶,筒	桐,通,彤,痛,童,瞳,同,铜
绍	少,召,哨	芍,勺,梢,烧,稍,捎
细	戏,夕,隙,系	息,希,习,吸,行,席,溪,锡,稀,牺,膝,熙,犀,携,媳,洗,熄,西,悉,晰,喜,惜,栖,嬉,蟋,厘,析,昔,徙,畦,袭
绅	身,深,信,呻,伸,参,申	肾,神,渗,审,沈,婶,甚,慎
组	诅,阻,祖	族,足,卒,租
累	垒,擂,泪,类,雷,蕾,儡	勒
终	忠,衷,盅,中,钟	仲,种,重,众,肿
羞	休,修	绣,宿,臭,秀,锈,朽,嗅,袖
翎	铃,凌,玲,龄,零,菱,陵,蛉,伶,灵	另,岭,领,令
习	席,息,昔,锡,惜,媳,袭,熄	希,吸,行,溪,稀,隙,牺,系,膝,熙,犀,携,戏,洗,西,悉,晰,喜,栖,嬉,蟋,厘,析,细,夕,徙,畦
聊	辽,燎,疗,缭,撩,僚,嘹,寥,潦	了,料
脯	父,抚,甫,斧,朴,府,葡,俯,仆,辅,腐,菩,蒲	瀑,辐,符,负,麸,咐,圃,复,缚,腹,服,扶,妇,夫,孵,仆,肤,赋,福,俘,附,浮,扑,蝠,浦,付,幅,普,谱,赴,暴,伏,芙,袱,拂,敷,铺,富,傅,副
脖	舶,白,膊,驳,搏,泊,渤,荸,卜,博,柏,勃,伯,薄	跛,簸,播,拨,剥,玻,般,菠
脱	拖,托	唾,鸵,拓,椭,驮,妥,驼
舵	惰,踱,跺,度,驮,堕	夺,朵,躲,多
舷	贤,闲,涎,嫌,衔,弦,咸	腺,宪,馅,先,掀,现,铣,鲜,纤,癣,限,显,县,陷,仙,献,险,线
舶	驳,白,膊,搏,脖,泊,渤,荸,卜,博,柏,勃,伯,薄	跛,簸,播,拨,剥,玻,般,菠
船	传	喘,穿,串,川
荸	舶,白,膊,驳,搏,脖,泊,渤,卜,博,柏,勃,伯,薄	跛,簸,播,拨,剥,玻,般,菠
荚	夹,挟,颊	夏,稼,价,佳,假,驾,茄,架,甲,嘉,钾,嫁,加,家,贾
茎	精,京,兢,晶,鲸,更,睛,荆,惊,经	径,境,竞,静,劲,净,警,靖,颈,阱,景,敬,镜,井,竟
莽		茫,芒,忙,氓,盲
莫	墨,末,寞,默,沫,磨,膜,没,漠,茉,脉,陌	么,蘑,摸,摹,魔,抹,摩,模
庄	妆,装,桩	状,撞,壮
莉	利,立,粒,隶,丽,砾,力,痢,厉,例,俐,雳,吏,历,励,沥,荔,栗	哩,李,里,理,厘,璃,离,漓,篱,梨,犁,礼,狸,鲤,黎
荷	盒,喝,何,禾,核,吓,合,鹤,赫,褐,盖,和,贺,河	呵
处	触,础,楚,畜,储,矗	厨,橱,初,锄,雏,出,除
彪	标,膘	表
蛇	谊,胰,甚,仪,什,夷,移,遗,舌,姨,疑,宜,一	掖,拾,已,乙,衣,忆,射,溢,易,肄,倚,屹,亿,意,艺,议,邑,义,医,绎,社,设,揖,毅,矣,摄,亦,译,益,赦,椅,尾,叶,逸,翼,漪,涉,奢,奕,液,役,壹,以,依,艾,舍,伊,蚁,抑,疫,异,腋,赊
蛀	柱,注,住,驻,铸,助,祝	轴,逐,猪,煮,蛛,主,竹,诸,属,烛,嘱,朱,拄,株,术,珠,贮,筑
蛆	圈,岖,俱,趋,沮,居,车,驱,区,锯,曲,躯,驹,屈,拘	足,拒,聚,举,剧,炬,句,巨,具,惧,漆,趣,矩,菊,据,取,橘,渠,娶,鞠,去,局,距
蛋	石,淡,旦,但,诞,担,弹,氮	丹,耽,胆,单
蚯	丘,秋,龟	囚,求,仇,球
蛉	铃,凌,玲,龄,零,菱,陵,翎,伶,灵	另,岭,领,令
被	坏,霹,辈,备,贝,狈,批,背,惫,焙,臂,倍,劈,匹,披	疲,杯,北,卑,否,譬,罢,脾,啤,皮,僻,碑,辟,屁,悲
袒	毯,坦	谈,叹,碳,瘫,昙,潭,滩,贪,谭,痰,坛,摊,弹,檀,探,炭
袖	绣,宿,臭,秀,锈,嗅	休,羞,修,朽
袍	咆,炮,刨	抛,跑,泡
袋	带,逮,待,大,代,怠,贷,戴	呆,歹
觅	密,蜜,秘,泌	咪,谜,弥,糜,迷,靡,米
规	瑰,闺,龟,归,傀	鬼,柜,贵,桂,轨,跪,诡
访	纺,仿	妨,坊,房,防,芳,方,放,肪
讶	轧,亚	押,哑,压,衙,雅,涯,呀,鸦,蚜,牙,芽,鸭
诀	倔,觉,掘,嚼,角,绝,脚,决,爵	
许	虎,唬	旭,需,蓄,虚,吁,糊,护,葫,须,畜,戏,絮,酗,湖,序,狐,互,弧,徐,壶,胡,叙,乎,蝴,绪,婿,续,沪,恤,呼,户,忽
设	社,拾,叶,舍,射,涉,摄,赦	蛇,舍,什,奢,舌,甚,赊
讼	送,诵,宋,颂	松,耸
讹	鹅,额,蛾,俄	噩,哑,阿,遏,恶,饿,愕,鳄,扼
贩	泛,犯,范,饭	矾,凡,烦,樊,番,繁,翻,帆,反,返
责	贼,寨,则,债,择,泽,窄,祭	怎,宅,摘,斋,侧,齐
贯	冠,观,罐,灌,惯	关,馆,棺,管,官
货	霍,豁,惑,祸,获,或	活,火,和,伙
贪	瘫,探,滩,摊	谈,叹,坦,昙,袒,潭,痰,坛,谭,炭,弹,檀,碳,毯
贫	濒,频	品,拼,聘
赦	社,拾,叶,设,舍,射,涉,摄	蛇,舍,什,奢,舌,甚,赊
趾	指,止,旨,只,址,纸,征	植,汁,蜘,织,吱,知,直,值,置,芝,滞,治,枝,至,职,秩,殖,帜,只,之,智,致,识,质,挚,窒,脂,稚,氏,执,支,肢,掷,制,志
软	蠕	
通		筒,桐,统,彤,痛,童,瞳,同,桶,铜
逗	豆,斗,读,痘	蚪,兜,抖,陡,都,斗
连	怜,联,廉,莲,帘,镰	炼,敛,练,恋,脸,链
速	肃,宿,素,诉,溯,塑,缩,粟	酥,俗,苏
逝	恃,适,誓,侍,饰,嗜,士,式,拭,事,示,室,释,识,市,使,世,势,是,氏,视,柿,试	拾,石,提,失,射,始,虱,十,屎,尸,矢,什,驶,匙,实,史,食,师,硕,湿,蚀,狮,诗,时,施
逐	轴,竹,烛,术,筑	柱,蛀,注,住,煮,蛛,驻,主,珠,诸,属,嘱,拄,朱,铸,株,助,猪,祝,贮
逞		澄,呈,橙,惩,承,称,成,程,秤,乘,撑,城,盛,诚
造	躁,噪,灶,燥,皂	糟,凿,蚤,枣,早,藻,澡,遭
透		偷,投,头
逢	冯,缝	疯,奉,峰,风,蜂,讽,丰,封,凤,枫,锋
逛		广,光
途	屠,凸,涂,图,突,徒	秃,土,吐,兔
部	埠,怖,步,不,布,簿	补,捕,卜,哺
郭	锅	过,国,果,裹
都	督,兜	蚪,豆,抖,妒,读,牍,渡,睹,陡,肚,杜,毒,逗,赌,度,痘,镀,斗,独,堵
酗	叙,絮,旭,绪,婿,蓄,续,畜,恤,序	徐,吁,需,须,许,虚
野	也,冶	业,叶,谒,爷,咽,夜,射,页,椰
钓	吊,调,掉	叼,雕,碉,刁
闭	币,毙,蔽,碧,毕,泌,避,璧,比,壁,弊,臂,辟,庇,鄙,必	笔,彼,逼,匕,鼻
陪	赔,培	坏,配,胚,佩,沛
陵	铃,凌,玲,龄,零,菱,翎,蛉,伶,灵	另,岭,领,令
陈	尘,忱,晨,沈,臣,沉,辰	趁,称,衬
陆	路,露,鹿,碌,馏,氯,溜,六,赂,录	留,瘤,卢,刘,流,炉,芦,榴,庐,卤,铆,琉,柳,颅,硫,鲁,泵,虏
阴	因,姻,音,殷,茵	隐,银,瘾,淫,引,吟,印,听,蚓,饮
陶	涛,逃,桃,萄,淘	讨,套,滔,掏
陷	腺,宪,现,限,馅,县,献,线	贤,险,先,闲,涎,掀,嫌,铣,鲜,衔,弦,纤,舷,显,癣,仙,咸
雀	确,壳,鹊,巧,却,怯,悄	峭,瞧,乔,窍,撬,桥,敲,锹,瘸,侨,翘,俏,跷,憔,缺
雪	削,穴,血	靴,学,薛
章	彰,樟,张	胀,丈,掌,长,杖,涨,障,帐,仗,账
竟	径,境,竞,静,劲,净,靖,敬,镜	精,京,兢,晶,鲸,警,颈,更,阱,景,睛,荆,惊,经,井,茎
顶	鼎	盯,定,订,钉,丁,锭,叮
顷	青,蜻,卿,氢,清,轻,倾,请	晴,亲,庆,情,擎
鱼	隅,愉,于,榆,愚,予,逾,渔,娱,舆	狱,雨,屿,预,语,欲,玉,御,吁,愈,豫,羽,喻,寓,誉,郁,浴,域,裕,迂,淤,育,宇,尉,谷,芋,与,遇
鸟		尿
卤	鲁,虏	路,卢,鹿,炉,碌,芦,氯,陆,庐,颅,露,赂,录
鹿	路,碌,氯,陆,露,赂,录	卢,炉,芦,庐,卤,颅,鲁,虏
麦	迈,脉,卖	埋,买
麻	么,蟆	码,蚂,妈,玛,骂,马,吗
傍	梆,邦,蚌,帮,磅,棒,旁,谤	膀,榜,绑
傅	父,赋,复,附,咐,负,副,富,赴,妇,腹,付	甫,辐,符,麸,缚,服,扶,辅,夫,孵,肤,福,俘,浮,蝠,抚,幅,斧,腐,芙,袱,拂,脯,府,俯,敷,伏
备	辈,贝,狈,背,惫,焙,臂,倍,被	北,杯,卑,碑,悲
傀	规,瑰,闺,龟,归	窥,亏,鬼,盔,愧,葵,魁,柜,贵,桂,轨,跪,诡,溃
伞	散	三,参
最	罪,醉	嘴,堆
凯	楷,岂,慨	开,咳,揩
割	搁,戈,胳,鸽,疙,哥,歌	个,格,葛,阁,合,各,隔,革,蛤
创	闯,囱,窗,疮	床,抢,幢,撞
剩	乘,圣,胜,盛	生,声,升,绳,甥,笙,省,牲
劳	烙,络,牢,唠,酪	捞,姥,老
胜	盛,生,乘,声,升,甥,牲,剩,圣,笙	绳,省
勋		循,讯,训,寻,驯,旬,巡,汛,询,殉,逊,迅
博	舶,白,膊,驳,搏,脖,泊,渤,荸,卜,柏,勃,伯,薄	跛,簸,播,拨,剥,玻,般,菠
喧	轩,宣	悬,炫,还,漩,玄,县,选,旋
啼	堤,提,蹄,题	剃,屉,体,梯,踢,剔,涕,替,惕
喊	罕	悍,韩,焊,函,汉,翰,憾,酣,旱,撼,含,汗,寒,和,涵,捍
喝	呵,吓,荷,赫,和,贺,鹤	盒,何,禾,核,合,褐,盖,河
喘		串,穿,川,船,传
喂	慰,胃,魏,尉,味,未,卫,位,为,遗,谓,蔚,伪,畏	危,薇,萎,威,唯,苇,违,委,偎,围,微,伟,桅,巍,维,纬,尾
喜	洗,徙	息,希,习,吸,行,席,溪,锡,稀,隙,牺,系,膝,熙,犀,携,媳,戏,熄,西,悉,晰,惜,栖,嬉,蟋,厘,析,昔,细,夕,畦,袭
丧	桑	嗓
喇	拉,啦	辣,落,腊,蜡
喳	插,叉,差,查,渣,扎	炸,乍,刹,闸,茶,察,眨,诈,岔,栅
单	善,丹,赡,扇,擅,担,耽,缠,馋,膳,蝉	石,淡,旦,蛋,诞,闪,胆,陕,山,阐,弹,铲,删,衫,但,珊,搀,掺,产,氮,杉
唾	拓	拖,托,鸵,脱,椭,驮,妥,驼
哟	邀,么,吆,妖,夭,腰,要	遥,乐,咬,谣,窑,舀,淆,钥,拗,姚,耀,肴,药,摇,侥
唤	焕,痪,幻,涣,宦,患,换	环,还,缓,欢
喻	狱,预,语,欲,玉,御,愈,吁,豫,寓,誉,郁,浴,域,裕,育,尉,谷,芋,与,遇	隅,羽,雨,屿,宇,愉,于,迂,鱼,愚,予,榆,逾,淤,渔,娱,舆
乔	瞧,侨,翘,桥,憔	峭,窍,壳,鹊,撬,雀,敲,巧,锹,悄,俏,跷
喉	猴,侯	吼,后,厚,候
围	薇,唯,违,为,微,桅,巍,维,危	威,委,谓,魏,味,未,喂,遗,畏,伟,尾,胃,位,伪,偎,纬,慰,尉,萎,卫,苇,蔚
堪	看,勘,刊	坎,砍
场	尝,长,裳,肠,厂,敞,常,偿	畅,唱,猖,倡,昌
堤	提,蹄,题,啼	剃,屉,体,梯,踢,剔,涕,替,惕
堰	燕,咽,焰,艳,研,沿,谚,厌,雁,砚,淹,验,唁,宴	延,癌,掩,阎,严,衍,烟,眼,奄,殷,演,颜,盐,炎,言
报	爆,豹,抱,暴,刨	胞,保,褒,雹,苞,宝,饱,包,堡,薄
堡	宝,饱,保	胞,薄,暴,爆,苞,雹,褒,豹,包,抱,报,刨
壹	依,医,揖,衣,漪,伊,一	掖,已,乙,忆,溢,易,肄,疑,倚,屹,亿,意,艺,议,邑,义,绎,毅,夷,移,矣,遗,亦,译,宜,益,尾,椅,蛇,逸,翼,奕,姨,液,役,以,谊,胰,艾,仪,蚁,抑,疫,异,腋
壶	糊,胡,蝴,葫,湖,狐,弧	护,许,乎,唬,沪,虎,互,戏,呼,户,忽
奠	惦,佃,淀,殿,电,店,垫,玷,甸	颠,碘,典,点
媚	妹,昧	眉,霉,梅,媒,楣,没,枚,每,美,煤,玫
婿	叙,絮,旭,绪,酗,蓄,续,畜,恤,序	徐,吁,需,须,许,虚
媒	眉,霉,梅,楣,没,枚,煤,玫	媚,每,美,昧,妹
寒	韩,函,含,汗,涵	悍,喊,罕,焊,汉,翰,憾,酣,旱,撼,和,捍
富	父,赋,复,附,咐,负,副,赴,腹,妇,傅,付	甫,辐,符,麸,缚,服,扶,辅,夫,孵,肤,福,俘,浮,蝠,抚,幅,斧,腐,芙,袱,拂,脯,府,俯,敷,伏
寓	狱,预,语,欲,玉,御,愈,吁,豫,喻,誉,郁,浴,域,裕,育,尉,谷,芋,与,遇	隅,羽,雨,屿,宇,愉,于,迂,鱼,愚,予,榆,逾,淤,渔,娱,舆
尊	遵	俊
寻	驯,旬,巡,询,循	辛,衅,信,欣,逊,讯,芯,训,薪,新,锌,汛,心,殉,勋,迅
就	旧,救,疚,臼,舅,究	酒,韭,鸠,久,灸,九,揪,玖,纠
嵌	铅,千,纤,迁,牵,谦,签	浅,钱,遣,谴,钳,黔,歉,欠,干,潜,前
幅	袱,拂,福,辐,俘,符,服,浮,蝠,缚,扶,夫,伏,芙	甫,复,麸,负,咐,腹,妇,辅,孵,父,肤,赋,附,付,抚,斧,赴,腐,脯,府,俯,敷,富,傅,副
帽	冒,貌,贸,茂	矛,毛,猫,锚,茅
廊	琅,狼,郎,榔	朗,浪
厕	测,策,册,伺,刺,次,赐,侧	词,此,雌,磁,辞,差,慈,祠,瓷
厢	镶,箱,乡,相,香,湘	响,向,享,祥,想,详,像,降,橡,巷,项,象,翔
彭	澎,蓬,棚,硼,朋,篷,膨,鹏	捧,碰,烹,砰
复	父,赋,付,负,咐,附,赴,腹,妇,富,副,傅	甫,辐,符,麸,缚,服,扶,辅,夫,孵,肤,福,俘,浮,蝠,抚,幅,斧,腐,芙,袱,拂,脯,府,俯,敷,伏
循	寻,驯,旬,巡,询	逊,讯,训,汛,殉,勋,迅
惑	霍,豁,祸,货,获,或	活,火,和,伙
恶	屋,于,诬,物,愕,误,噩,污,勿,呜,遏,乌,坞,哑,务,俄,雾,晤,巫,饿,悟,鳄,扼	侮,武,鹉,舞,无,梧,讹,亡,额,午,蜈,蛾,五,捂,鹅,芜,吴,伍,阿
悲	碑,背,卑,杯	辈,北,备,贝,狈,惫,焙,臂,倍,被
闷		们,门
惠	慧,绘,讳,晦,诲,会,汇,秽,贿,溃	悔,灰,恢,毁,辉,茴,徽,回,蛔,挥,虫,堕
愕	噩,哑,遏,俄,恶,饿,鳄,扼	讹,鹅,额,蛾,阿
惰	踱,跺,舵,度,驮,堕	夺,朵,躲,多
慨	咳,楷,凯,岂	开,揩
恼	脑	闹,挠
惶	皇,凰,黄,蝗,煌	恍,谎,幌,慌,晃,荒
愉	隅,于,榆,鱼,愚,予,逾,渔,娱,舆	狱,雨,屿,预,语,欲,玉,御,吁,愈,豫,羽,喻,寓,誉,郁,浴,域,裕,迂,淤,育,宇,尉,谷,芋,与,遇
掌	长,涨	胀,樟,丈,杖,障,张,帐,彰,仗,账,章
描	瞄,苗	渺,秒,妙,藐,庙
拣	碱,茧,减,剪,检,简,俭,捡,柬	箭,见,建,歼,艰,煎,件,贱,键,践,鉴,舰,肩,渐,监,间,坚,尖,健,荐,剑,奸,涧,溅,兼
揩	开	楷,咳,凯,岂,慨
揉	蹂,柔	肉
揍	骤,奏	走
插	叉,差,喳	刹,茶,查,察,岔
提	堤,拾,石,什,蚀,射,食,时,实,硕,题,十,蹄,啼	恃,失,适,誓,侍,始,虱,体,饰,嗜,士,涕,式,拭,屎,事,示,室,尸,释,梯,替,识,惕,市,使,矢,世,驶,匙,势,史,踢,剔,是,师,湿,氏,剃,视,屉,狮,诗,柿,逝,施,试
握	沃,卧	涡,窝,我
揖	依,医,衣,漪,伊,壹,一	掖,已,乙,忆,溢,易,肄,疑,倚,屹,亿,意,艺,议,邑,义,绎,毅,夷,移,矣,遗,亦,译,宜,益,尾,椅,蛇,逸,翼,奕,姨,液,役,以,谊,胰,艾,仪,蚁,抑,疫,异,腋
揭	街,结,皆,阶,接	借,界,诫,洁,劫,捷,姊,姐,介,截,戒,竭,芥,杰,届,节,解
挥	灰,恢,辉,徽,堕	慧,绘,惠,悔,贿,讳,汇,毁,晦,茴,诲,会,溃,蛔,秽,虫,回
捶	锤,垂,椎	吹,炊
援	缘,源,辕,猿,员,园,袁,圆,原,元	宛,远,怨,愿,院,冤,渊,鸳
揪	鸠,纠	酒,救,旧,疚,韭,臼,久,舅,灸,究,九,就,玖
换	焕,痪,幻,涣,唤,宦,患	环,还,缓,欢
扬	杨,羊,阳,洋	养,央,氧,样,鸯,漾,仰,殃,秧,痒
敞	厂,场	畅,唱,尝,长,裳,猖,肠,常,偿,倡,昌
敦	墩,蹲	盾,顿,吨,钝,囤,盹
敢	赶,感,秆,橄,杆	柑,杆,竿,甘,肝,干
散	伞	三,参
斑	班,扳,颁,搬,般	版,伴,办,板,拌,半,瓣,绊,扮
斯	私,撕,思,司,丝,嘶	伺,肆,四,赐,食,饲,死,寺,似
普	谱,圃,浦	瀑,朴,葡,脯,仆,铺,扑,暴,菩,蒲
晰	西,悉,希,溪,厘,析,稀,栖,牺,嬉,膝,熙,犀,吸,蟋,行,携,畦	席,息,习,昔,锡,喜,惜,细,夕,隙,系,徙,熄,媳,袭,洗,戏
晴	情,擎,倾	顷,青,蜻,亲,卿,氢,庆,轻,清,请
晶	精,京,兢,鲸,更,睛,荆,惊,经,茎	径,境,竞,静,劲,净,警,靖,颈,阱,景,敬,镜,井,竟
景	影,警,颈,阱,井,颖	婴,兢,静,晶,鲸,靖,鹦,樱,盈,莹,映,惊,竟,精,迎,境,更,睛,茎,径,萤,赢,鹰,京,蝇,劲,英,敬,荆,莺,硬,竞,应,荧,净,营,缨,镜,经
暑	鼠,薯,数,蜀,属,署,黍	树,赎,述,梳,束,恕,蔬,输,疏,抒,竖,书,曙,淑,墅,术,庶,枢,漱,熟,叔,舒,殊
智	质,知,挚,识,秩,制,帜,志,窒,治,置,滞,稚,致,至	植,汁,蜘,织,吱,旨,直,值,芝,枝,职,殖,只,之,趾,指,止,纸,脂,氏,执,支,肢,掷,址,征
晾	凉,亮,量,谅,辆	粮,良,粱,俩,两,梁
曾	层,憎,增	赠
替	屉,剃,涕,惕	堤,题,提,体,梯,踢,剔,蹄,啼
期	几,箕,崎,鳍,稽,其,鸡,枝,旗,居,肌,脐,只,机,叽,讥,祈,唧,激,饥,绩,歧,积,基,棋,骑,奇,畦,畸,迹,齐	吉,吃,技,气,即,圾,启,起,柒,集,祭,冀,嫉,戚,籍,借,弃,脊,溪,际,级,寂,寄,系,剂,迄,继,忌,器,泣,击,欺,极,季,漆,记,砌,纪,妓,济,栖,乞,辑,荠,计,七,疾,既,及,己,急,凄,妻,给,鲫,挤,契,汽,岂,棘,企
朝	招,着,昭,巢,潮,召,嘲	沼,罩,钞,炒,找,抄,爪,吵,赵,超,剿,照,兆
棺	冠,观,关,官	罐,馆,灌,管,贯,惯
棕	纵,踪,综,宗	从,总
棠	塘,膛,搪,堂,糖,唐	烫,淌,汤,趟,倘,躺
棘	吉,极,借,及,吃,脊,唧,即,急,圾,级,寂,集,辑,嫉,疾,击,籍	技,几,箕,其,稽,祭,冀,鸡,际,居,肌,寄,系,剂,继,机,忌,叽,讥,期,季,激,饥,记,济,绩,纪,妓,荠,计,积,既,基,己,鲫,骑,奇,挤,畸,迹,给
枣	蚤,澡,藻,早	糟,躁,凿,造,噪,灶,燥,遭,皂
椅	已,乙,蚁,矣,倚,以,尾	掖,衣,忆,溢,易,肄,疑,屹,一,亿,意,艺,议,邑,义,医,绎,揖,毅,夷,移,遗,亦,译,宜,益,蛇,逸,翼,漪,奕,姨,液,役,壹,依,谊,胰,艾,仪,伊,抑,疫,异,腋
栋	洞,冻,动	董,东,懂,冬
棵	刻,颗,科,磕,苛,蝌	坷,壳,克,可,咳,课,客,渴
栈	占,站,战,颤,暂,蘸,绽	毡,斩,盏,展,崭,瞻,沾
棒	傍,蚌,磅,谤,旁	膀,梆,邦,帮,榜,绑
栖	希,柒,吸,行,戚,溪,稀,牺,膝,熙,犀,携,欺,西,悉,晰,漆,嬉,蟋,七,厘,析,妻,凄,畦	息,气,习,启,起,鳍,稽,其,崎,枝,席,弃,旗,锡,隙,脐,只,系,迄,器,媳,泣,戏,洗,熄,祈,期,乞,砌,惜,喜,企,歧,昔,棋,细,夕,徙,骑,奇,契,汽,岂,袭,齐
棋	祈,期,旗,脐,只,崎,鳍,奇,其,骑,歧,畦,枝,齐	气,启,起,柒,稽,戚,弃,溪,迄,器,泣,欺,漆,砌,乞,栖,七,凄,妻,契,汽,岂,企
棍		滚
植	质,执,职,掷,殖,直,值	吱,汁,蜘,织,知,旨,置,芝,滞,治,枝,至,秩,只,帜,之,智,趾,致,识,指,止,挚,窒,纸,脂,稚,氏,支,肢,制,址,志,征
椒	蕉,教,焦,骄,交,郊,礁,浇,胶,娇	窖,搅,缴,叫,觉,轿,狡,矫,嚼,角,侥,校,脚,剿,较,饺,绞
椎	追,锤,捶,垂,锥	坠,吹,赘,炊,缀
棉	绵,眠	冕,免,面,勉,缅,娩
棚	澎,蓬,彭,硼,朋,篷,膨,鹏	捧,碰,烹,砰
款		宽
欺	溪,凄,漆,妻,栖,柒,七,戚	气,启,起,鳍,稽,其,崎,枝,弃,旗,脐,只,迄,器,泣,祈,期,乞,砌,歧,齐,棋,骑,奇,契,畦,汽,岂,企
钦	亲,侵	禽,勤,秦,芹,擒,寝,琴
残	惭,蚕	灿,餐,惨,参
殖	植,质,执,职,掷,直,值	吱,汁,蜘,织,知,旨,置,芝,滞,治,枝,至,秩,只,帜,之,智,趾,致,识,指,止,挚,窒,纸,脂,稚,氏,支,肢,制,址,志,征
壳	峭,确,窍,撬,鹊,雀,俏,咳,翘,却,怯,跷	棵,科,敲,课,瘸,侨,桥,憔,瞧,坷,颗,可,锹,苛,客,悄,乔,克,刻,巧,磕,缺,渴,蝌
毯	袒,坦	谈,叹,碳,瘫,昙,潭,滩,贪,谭,痰,坛,摊,弹,檀,探,炭
氮	石,淡,蛋,但,旦,诞,担,弹	丹,耽,胆,单
氯	虑,滤,路,率,鹿,碌,绿,陆,律,露,赂,录	缕,卢,旅,炉,铝,侣,吕,芦,娄,驴,庐,屡,卤,颅,履,鲁,虏
港	岗	肛,刚,纲,钢,冈,扛,缸
游	由,犹,油,尤,邮	佑,又,优,幽,幼,右,诱,悠,忧,有,友
渡	妒,肚,度,镀,杜	睹,牍,读,毒,督,都,赌,独,堵
凑		糙,臭,操
渠		圈,岖,蛆,取,趋,漆,娶,趣,驱,区,去,曲,躯,屈
渣	查,眨,扎,喳	炸,乍,闸,诈,栅
减	碱,茧,拣,剪,检,简,俭,捡,柬	箭,见,建,歼,艰,煎,件,贱,键,践,鉴,舰,肩,渐,监,间,坚,尖,健,荐,剑,奸,涧,溅,兼
湘	镶,箱,乡,厢,相,香	响,向,享,祥,想,详,像,降,橡,巷,项,象,翔
渤	舶,白,膊,驳,搏,脖,泊,荸,卜,博,柏,勃,伯,薄	跛,簸,播,拨,剥,玻,般,菠
湖	糊,壶,胡,蝴,葫,狐,弧	护,许,乎,唬,沪,虎,互,戏,呼,户,忽
涡	窝	握,沃,我,卧
汤	伤,商	赏,上,膛,烫,搪,塘,裳,淌,晌,趟,倘,躺,堂,糖,唐,棠,尚
渴	可,坷	刻,颗,壳,克,棵,科,磕,咳,课,客,苛,蝌
渺	藐,秒	瞄,苗,妙,描,庙
测	厕,策,侧,册	
湃	派	排,拍,牌,徘
浑	魂,混	婚,荤,昏
滋	姿,咨,吱,资	紫,字,自,滓,籽,仔,子
溉	盖,丐,概,钙	该,改
涣	焕,痪,幻,唤,宦,患,换	环,还,缓,欢
焙	辈,备,贝,狈,背,惫,臂,倍,被	北,杯,卑,碑,悲
焚	坟	份,吩,忿,芬,粪,奋,粉,纷,愤,分,氛
焦	蕉,教,椒,骄,交,郊,礁,浇,胶,娇	窖,搅,缴,叫,觉,轿,狡,矫,嚼,角,侥,校,脚,剿,较,饺,绞
焰	燕,验,咽,艳,研,沿,谚,厌,雁,砚,宴,堰,唁,淹	延,癌,掩,阎,严,衍,烟,眼,奄,殷,演,颜,盐,炎,言
无	梧,巫,亡,蜈,吴,诬,芜	屋,武,于,物,误,污,侮,勿,呜,舞,五,乌,坞,务,雾,晤,鹉,午,捂,恶,悟,伍
然	燃	染
煮	主,属,嘱,拄,贮	柱,轴,蛀,逐,注,住,蛛,驻,珠,竹,诸,烛,助,朱,铸,株,术,猪,祝,筑
牌	排,徘	拍,派,湃
犀	西,悉,希,晰,溪,厘,析,稀,栖,牺,嬉,膝,熙,吸,蟋,行,携,畦	席,息,习,昔,锡,喜,惜,细,夕,隙,系,徙,熄,媳,袭,洗,戏
犹	由,油,游,尤,邮	佑,又,优,幽,悠,幼,诱,右,忧,有,友
猴	喉,侯	吼,后,厚,候
猩	兴,星,腥	幸,型,刑,醒,邢,形,省,行,杏,性,姓
琳	淋,磷,邻,鳞,林,临	凛,赁,吝,躏
琢	茁,啄,酌,着,卓,灼,浊,拙	桌,捉
琴	禽,勤,秦,芹,擒	亲,寝,侵,钦
甥	生,胜,升,声,牲,笙	绳,剩,乘,圣,省,盛
画	话,化,划,桦,华	滑,划,猾,豁,花,哗
番	翻,帆	犯,矾,凡,泛,烦,樊,饭,繁,贩,范,反,返
痢	利,立,粒,隶,丽,砾,力,莉,厉,例,俐,雳,吏,历,励,沥,荔,栗	哩,李,里,理,厘,璃,离,漓,篱,梨,犁,礼,狸,鲤,黎
痛		筒,桐,通,统,彤,童,瞳,同,桶,铜
痘	逗,豆,斗,读	蚪,兜,抖,陡,都,斗
登	灯	瞪,蹬,邓,等,凳
发	伐,法	法,筏,伐,阀,罚,乏
盗	蹈,导,到,悼,倒,道,稻	祷,岛,叨,捣,刀
短		缎,锻,段,端,断
硝	哮,销,萧,嚣,削,宵,箫,消	小,啸,酵,校,学,肖,效,孝,笑,晓
硬	映,应	萤,鹰,赢,影,婴,莺,蝇,樱,迎,荧,营,英,缨,景,鹦,盈,莹,颖
砚	燕,验,咽,焰,艳,研,沿,谚,厌,雁,淹,堰,唁,宴	延,癌,掩,阎,严,衍,烟,眼,奄,殷,演,颜,盐,炎,言
稍	烧,捎,梢	芍,勺,哨,少,绍,召
秆	敢,赶,感,橄,杆	柑,杆,竿,甘,肝,干
程	澄,呈,橙,惩,承,成,乘,城,盛,诚	撑,逞,秤,称
税	蜕,说,睡	水,谁
稀	西,悉,希,晰,溪,厘,析,栖,牺,嬉,膝,熙,犀,吸,蟋,行,携,畦	席,息,习,昔,锡,喜,惜,细,夕,隙,系,徙,熄,媳,袭,洗,戏
窘		君,俊,钧,峻,骏,竣,龟,均,菌,军
窗	囱,创,疮	撞,抢,床,闯,幢
窖	教,叫,觉,校,轿,较	焦,角,交,脚,剿,娇,蕉,狡,胶,侥,椒,骄,嚼,郊,饺,绞,搅,缴,矫,礁,浇
童	桐,彤,瞳,同,铜	筒,通,统,痛,桶
竣	俊,骏,峻,菌	君,钧,窘,龟,均,军
等		灯,登,瞪,蹬,邓,凳
策	测,厕,侧,册	
笔	比,匕,彼,鄙	闭,币,毙,蔽,逼,碧,毕,避,璧,泌,壁,弊,鼻,辟,臂,庇,必
筐	框	狂,况,眶,矿,旷
筒	统,桶	桐,通,彤,痛,童,瞳,同,铜
答	达,瘩,搭	大,打
笋	损	孙
筋	津,巾,襟,金,禁,今,浸,斤	近,仅,尽,晋,劲,锦,进,谨,紧
筏	法,阀,伐,乏,罚	发
筑	轴,逐,竹,烛,术	柱,蛀,注,住,煮,蛛,驻,主,珠,诸,属,嘱,拄,朱,铸,株,助,猪,祝,贮
粟	肃,速,宿,素,诉,溯,塑,缩	酥,俗,苏
粥	周,舟,州,洲	轴,帚,宙,咒,肘,昼,皱
绞	搅,缴,狡,矫,角,脚,剿,较,饺,侥	窖,蕉,教,焦,叫,觉,椒,骄,嚼,交,校,郊,礁,浇,轿,胶,娇
结	街,洁,揭,皆,阶,劫,捷,截,竭,接,杰,节	借,界,诫,解,介,芥,姊,届,戒,姐
绒	蓉,融,熔,容,茸,榕,溶,荣	冗
绝	诀,倔,觉,掘,嚼,角,脚,决,爵	
紫	仔,子,滓,籽	吱,资,字,自,滋,姿,咨
絮	叙,旭,绪,酗,婿,蓄,续,畜,恤,序	徐,吁,需,须,许,虚
丝	私,撕,思,司,斯,嘶	伺,肆,四,赐,食,饲,死,寺,似
络	洛,烙,骆,落,劳,酪	萝,姥,螺,骡,箩,罗,逻,牢,裸,捞,锣,唠,老
给	己,脊,几,济,挤	吉,吃,技,即,圾,箕,其,稽,集,祭,冀,嫉,鸡,籍,借,际,级,居,寂,寄,肌,系,剂,继,机,忌,叽,击,讥,极,期,季,唧,激,饥,记,绩,纪,妓,辑,计,积,疾,既,基,及,急,鲫,骑,奇,畸,棘,迹,荠
善	赡,扇,擅,膳,单	删,山,衫,珊,闪,杉,陕
翔	详,祥,降	响,向,镶,箱,享,乡,想,厢,相,像,巷,橡,香,湘,项,象
肃	速,宿,素,诉,溯,塑,缩,粟	酥,俗,苏
腕	万,玩,惋	弯,宛,挽,婉,碗,丸,完,顽,湾,晚,豌,娩
腔	将,抢,呛,枪	墙,强
腋	掖,衣,忆,溢,肄,易,屹,一,亿,意,艺,邑,义,绎,议,毅,亦,译,益,逸,翼,奕,液,役,谊,艾,抑,疫,异	已,乙,疑,倚,医,揖,夷,移,矣,遗,宜,尾,椅,蛇,漪,姨,壹,以,依,胰,仪,伊,蚁
肾	慎,甚,渗	绅,身,深,神,呻,信,伸,沈,审,婶,参,申
胀	丈,长,杖,涨,障,帐,仗,账	樟,掌,张,彰,章
脾	皮,疲,罢,啤	坏,霹,譬,否,僻,批,辟,屁,劈,被,匹,披
舒	枢,抒,梳,书,蔬,殊,输,疏	鼠,蜀,树,赎,述,暑,束,恕,黍,薯,竖,曙,淑,属,墅,术,庶,漱,数,熟,叔,署
菩	朴,脯,葡,仆,蒲	瀑,暴,普,圃,谱,铺,扑,浦,仆
萍	屏,冯,凭,苹,坪,平,评,瓶	乒
菠	播,拨,剥,玻,般	跛,舶,驳,膊,白,簸,搏,脖,泊,渤,荸,卜,博,柏,勃,伯,薄
华	滑,话,化,划,桦,猾,豁,花,画,哗	
菱	铃,凌,玲,龄,零,陵,翎,蛉,伶,灵	另,岭,领,令
着	茁,啄,酌,琢,招,卓,遮,昭,朝,浊,灼,拙,召,嘲	沼,罩,这,捉,照,宅,浙,摘,找,桌,爪,哲,赵,折,者,辙,兆,蔗
莱	来	赖,癞
萌	檬,蒙,朦,盟	孟,梦,锰,猛
菌	俊,骏,竣,峻	君,钧,窘,龟,均,军
菲	飞,匪,啡,诽,非	费,沸,肺,废,肥,吠
菊	鞠,局,橘	拒,足,聚,举,剧,炬,沮,居,锯,句,巨,具,拘,惧,矩,蛆,俱,据,车,驹,距
萎	纬,威,苇,委,伟,偎,尾	谓,巍,魏,味,未,围,喂,遗,畏,胃,薇,位,为,微,桅,伪,维,慰,尉,唯,卫,违,蔚,危
萄	涛,逃,桃,陶,淘	讨,套,滔,掏
菜	采	彩,踩,材,睬,裁,猜,财,才,采
虚	须,吁,需	徐,叙,絮,旭,绪,酗,婿,蓄,续,畜,恤,序,许
蛙	洼,挖	袜,瓦,娃
蛔	茴,回	慧,绘,惠,悔,灰,贿,讳,恢,毁,晦,辉,徽,诲,会,溃,汇,秽,挥,虫,堕
蛛	珠,诸,朱,株,猪	柱,轴,蛀,逐,注,住,煮,驻,主,竹,属,烛,嘱,拄,铸,术,助,祝,贮,筑
蛤	格,葛,阁,合,隔,革	哈,个,搁,戈,胳,鸽,各,疙,割,哥,歌
街	结,揭,皆,阶,接	借,界,诫,洁,劫,捷,姊,姐,介,截,戒,竭,芥,杰,届,节,解
裁	才,财,材	彩,踩,睬,猜,菜,采
裂	猎,烈,劣,列	咧
袱	幅,拂,福,辐,俘,符,服,浮,蝠,缚,扶,夫,伏,芙	甫,复,麸,负,咐,腹,妇,辅,孵,父,肤,赋,附,付,抚,斧,赴,腐,脯,府,俯,敷,富,傅,副
视	恃,适,誓,侍,饰,嗜,士,式,拭,事,示,室,释,识,市,使,世,势,是,氏,柿,逝,试	拾,石,提,失,射,始,虱,十,屎,尸,矢,什,驶,匙,实,史,食,师,硕,湿,蚀,狮,诗,时,施
咏	踊,蛹,泳,勇,永,拥	庸,用,佣
评	屏,冯,凭,苹,坪,平,萍,瓶	乒
词	雌,磁,辞,慈,祠,瓷	此,伺,刺,次,差,赐,厕
诅	组,阻,祖	族,足,卒,租
诈	乍,炸,栅	闸,喳,查,眨,渣,扎
诉	肃,速,宿,素,溯,塑,缩,粟	酥,俗,苏
诊	疹,枕,侦,真,珍,贞,榛,斟,针	阵,震,镇,振
象	向,乡,像,相,巷,橡,项	响,镶,享,箱,祥,想,详,厢,降,香,湘,翔
贮	煮,主,属,嘱,拄	柱,轴,蛀,逐,注,住,蛛,驻,珠,竹,诸,烛,助,朱,铸,株,术,猪,祝,筑
贴	帖	铁
贰	二	耳,儿,尔,而,饵
费	肺,沸,废,吠	飞,匪,啡,菲,诽,肥,非
贺	喝,吓,荷,赫,和,鹤	盒,呵,何,禾,核,合,褐,盖,河
贵	跪,柜,桂	规,鬼,诡,瑰,闺,龟,轨,归,傀
买		脉,麦,迈,卖,埋
贬	扁,匾	蝙,边,变,便,辩,辫,辨,编,鞭,遍
贸	冒,貌,帽,茂	矛,毛,猫,锚,茅
贷	带,逮,待,大,代,怠,袋,戴	呆,歹
越	乐,悦,钥,跃,月,耀,粤,阅,岳,药,说	约
超	抄,剿,钞	炒,朝,吵,巢,潮,嘲
趁	称,衬	陈,尘,忱,晨,沈,臣,沉,辰
距	拒,足,惧,炬,俱,据,聚,锯,句,巨,具,剧	菊,蛆,沮,居,橘,车,鞠,矩,举,局,驹,拘
跋	拔	爸,捌,芭,笆,扒,坝,耙,巴,靶,罢,叭,八,疤,霸,伯,吧,把
跑		抛,袍,炮,咆,泡,刨
跌	蝶,谍,叠,碟	爹
跛	簸	舶,驳,播,渤,柏,勃,膊,荸,般,卜,博,薄,菠,脖,泊,伯,白,搏,拨,剥,玻
轴	逐,竹,烛,术,筑	柱,州,注,周,帚,主,驻,咒,朱,珠,宙,拄,肘,铸,粥,煮,属,嘱,猪,贮,皱,蛀,洲,住,蛛,舟,诸,株,助,祝,昼
辜	沽,咕,估,家,姑,孤	滑,雇,凸,古,告,固,故,谷,骨,顾,股,鼓,贾
逮	带,待,歹,大,代,怠,贷,袋,戴	呆
逸	掖,衣,忆,溢,肄,易,屹,一,亿,意,艺,邑,义,绎,议,毅,亦,译,益,翼,奕,液,役,谊,艾,腋,抑,疫,异	已,乙,疑,倚,医,揖,夷,移,矣,遗,宜,尾,椅,蛇,漪,姨,壹,以,依,胰,仪,伊,蚁
进	近,晋,尽,仅,劲,禁,浸	津,巾,襟,锦,筋,金,谨,今,紧,斤
邮	由,犹,油,游,尤	佑,又,优,幽,悠,幼,诱,右,忧,有,友
乡	向,镶,箱,像,相,厢,橡,巷,香,湘,项,象	响,享,祥,想,降,详,翔
酣	和	悍,韩,喊,罕,焊,函,汉,翰,憾,旱,撼,含,汗,寒,涵,捍
酥	苏	肃,速,宿,俗,素,诉,溯,塑,缩,粟
量	晾,粮,良,凉,粱,亮,谅,辆,梁	俩,两
钞	超,抄,剿	炒,朝,吵,巢,潮,嘲
钮	扭,纽	牛,拗
钙	溉,盖,概,丐	该,改
钠	那,娜,捺,纳,呐	拿,哪
钧	君,龟,均,军	俊,窘,峻,骏,竣,菌
钝	盾,顿,吨,囤,盹	墩,蹲,敦
闰	润	
开	揩	楷,咳,凯,岂,慨
闲	贤,涎,嫌,衔,弦,舷,咸	腺,宪,馅,先,掀,现,铣,鲜,纤,癣,限,显,县,陷,仙,献,险,线
间	箭,见,建,歼,艰,煎,件,贱,键,践,鉴,舰,肩,渐,监,坚,尖,健,荐,剑,奸,涧,溅,兼	碱,茧,拣,减,剪,检,简,俭,捡,柬
队	对,兑	堆
阶	街,结,揭,皆,接	借,界,诫,洁,劫,捷,姊,姐,介,截,戒,竭,芥,杰,届,节,解
阳	杨,扬,羊,洋	养,央,氧,样,鸯,漾,仰,殃,秧,痒
隅	愉,于,榆,鱼,愚,予,逾,渔,娱,舆	狱,雨,屿,预,语,欲,玉,御,吁,愈,豫,羽,喻,寓,誉,郁,浴,域,裕,迂,淤,育,宇,尉,谷,芋,与,遇
隆	龙,咙,窿,聋,胧,笼	垄,拢
雁	燕,验,咽,焰,艳,研,沿,谚,厌,淹,砚,堰,唁,宴	延,癌,掩,阎,严,衍,烟,眼,奄,殷,演,颜,盐,炎,言
雅	亚,哑	押,压,衙,轧,讶,涯,呀,鸦,蚜,牙,芽,鸭
雄	熊	凶,胸,汹,兄,匈
集	吉,极,借,及,吃,脊,唧,即,急,圾,级,寂,辑,嫉,击,疾,棘,籍	技,几,箕,其,稽,祭,冀,鸡,际,居,肌,寄,系,剂,继,机,忌,叽,讥,期,季,激,饥,记,济,绩,纪,妓,荠,计,积,既,基,己,鲫,骑,奇,挤,畸,迹,给
雇	告,故,固,估,顾	滑,凸,古,沽,咕,谷,骨,孤,股,鼓,姑,家,贾,辜
韧	刃,纫,任,认,赁	人,仁,儿,忍
项	向,乡,像,相,巷,橡,象	响,镶,享,箱,祥,想,详,厢,降,香,湘,翔
顺	瞬	吮,盾
须	虚,吁,需	徐,叙,絮,旭,绪,酗,蓄,婿,续,畜,恤,序,许
饭	泛,贩,犯,范	矾,凡,烦,樊,番,繁,翻,帆,反,返
饮	隐,瘾,引,印,听,蚓	因,姻,音,银,淫,吟,殷,茵,阴
冯	屏,缝,坪,凭,苹,平,评,逢,萍,瓶	疯,奉,峰,风,蜂,讽,丰,封,凤,乒,枫,锋
黄	惶,皇,凰,蝗,煌	恍,谎,幌,慌,晃,荒
黍	鼠,薯,数,蜀,暑,属,署	树,赎,述,梳,束,恕,蔬,输,疏,抒,竖,书,曙,淑,墅,术,庶,枢,漱,熟,叔,舒,殊
黑	嘿	
乱		卵,峦
债	责,寨,祭	宅,摘,窄,斋,齐
傲	懊,澳,拗,奥	袄,凹,熬
传	撰,转,船,赚	串,穿,专,川,喘,砖
仅	近,晋,尽,劲,锦,进,谨,禁,紧,浸	津,巾,襟,筋,金,今,斤
倾	顷,青,晴,蜻,卿,氢,轻,清,情,擎	亲,庆,请
催	摧,衰,崔	脆,翠,粹,悴
伤	汤,商	赏,裳,晌,上,尚
傻		霎,煞,沙,杀,砂,厦,纱,杉
剿	搅,缴,钞,狡,矫,侥,角,抄,脚,超,较,饺,绞	窖,焦,炒,交,巢,娇,蕉,吵,校,潮,胶,叫,觉,椒,骄,嚼,朝,郊,轿,嘲,教,礁,浇
募	沐,牧,幕,慕,睦,穆,暮,目,墓,木	姥,拇,牡,模,母,姆,亩
勤	禽,秦,芹,擒,琴	亲,寝,侵,钦
势	恃,适,誓,侍,饰,嗜,士,式,拭,事,示,室,释,识,市,使,世,是,氏,视,柿,逝,试	拾,石,提,失,射,始,虱,十,屎,尸,矢,什,驶,匙,实,史,食,师,硕,湿,蚀,狮,诗,时,施
汇	慧,惠,绘,讳,晦,诲,会,秽,贿,溃	堕,悔,灰,恢,毁,辉,徽,茴,蛔,挥,虫,回
嗓		丧,桑
嗦	梭,缩,唆	所,琐,锁,索
吗	码,蚂,妈,玛,马,蟆	么,骂,麻
嗜	恃,适,誓,侍,饰,士,式,拭,事,示,室,释,识,市,使,世,势,是,氏,视,柿,逝,试	拾,石,提,失,射,始,虱,十,屎,尸,矢,什,驶,匙,实,史,食,师,硕,湿,蚀,狮,诗,时,施
嗤	吃	池,齿,持,侈,翅,斥,驰,迟,耻,匙,赤,尺,弛
呜	污,屋,于,巫,恶,诬,乌	武,芜,物,误,侮,勿,无,舞,五,吴,坞,梧,务,蜈,雾,晤,鹉,午,亡,捂,悟,伍
嗡	翁	
嗅	绣,臭,宿,秀,锈,袖	休,羞,修,朽
呛	将,抢,腔,枪	墙,强
园	援,缘,源,辕,猿,员,袁,圆,原,元	宛,远,怨,愿,院,冤,渊,鸳
圆	援,缘,源,辕,猿,员,园,袁,原,元	宛,远,怨,愿,院,冤,渊,鸳
塞	涩,瑟,腮,赛,圾,色	
塑	肃,速,宿,素,诉,溯,缩,粟	酥,俗,苏
塘	膛,搪,堂,糖,唐,棠	烫,淌,汤,趟,倘,躺
涂	屠,凸,图,途,突,徒	秃,土,吐,兔
塔		塌,蹋,踏
填	甜,恬,田	添,舔,天
块	刽,筷,会,快	
坞	晤,误,勿,务,恶,悟,雾,物	屋,武,于,芜,污,侮,呜,无,舞,五,吴,乌,梧,蜈,鹉,午,巫,亡,捂,诬,伍
奥	懊,傲,拗,澳	袄,凹,熬
嫁	稼,价,假,驾,架,贾	夏,夹,佳,茄,甲,挟,钾,嘉,加,荚,家,颊
嫉	吉,极,借,及,吃,脊,唧,即,急,圾,级,寂,集,辑,击,疾,棘,籍	技,几,箕,其,稽,祭,冀,鸡,际,居,肌,寄,系,剂,继,机,忌,叽,讥,期,季,激,饥,记,济,绩,纪,妓,荠,计,积,既,基,己,鲫,骑,奇,挤,畸,迹,给
嫌	贤,闲,涎,衔,弦,舷,咸	腺,宪,馅,先,掀,现,铣,鲜,纤,癣,限,显,县,陷,仙,献,险,线
妈	吗	码,么,麻,蚂,玛,骂,马,蟆
媳	席,息,习,锡,昔,惜,袭,熄	希,吸,行,溪,稀,隙,牺,系,膝,熙,犀,携,戏,洗,西,悉,晰,喜,栖,嬉,蟋,厘,析,细,夕,徙,畦
嫂	扫	骚,艘,搔
幌	谎,晃,恍	惶,皇,凰,黄,慌,蝗,煌,荒
廉	怜,联,莲,连,帘,镰	炼,敛,练,恋,脸,链
厦	下,夏,霎,煞,暇,吓	沙,侠,辖,虾,斜,杀,狭,傻,匣,挟,砂,峡,纱,霞,杉,洽,瞎
微	薇,唯,违,围,为,桅,巍,维,危	威,委,谓,魏,味,未,喂,遗,畏,伟,尾,胃,位,伪,偎,纬,慰,尉,萎,卫,苇,蔚
愚	隅,愉,于,榆,鱼,予,逾,渔,娱,舆	狱,雨,屿,预,语,欲,玉,御,吁,愈,豫,羽,喻,寓,誉,郁,浴,域,裕,迂,淤,育,宇,尉,谷,芋,与,遇
意	掖,衣,忆,溢,肄,易,屹,一,亿,议,艺,邑,义,绎,毅,亦,译,益,逸,翼,奕,液,役,谊,艾,腋,抑,疫,异	已,乙,疑,倚,医,揖,夷,移,矣,遗,宜,尾,椅,蛇,漪,姨,壹,以,依,胰,仪,伊,蚁
慈	词,雌,磁,辞,祠,瓷	此,伺,刺,次,差,赐,厕
感	敢,赶,秆,橄,杆	柑,杆,竿,甘,肝,干
想	响,享	向,镶,箱,乡,祥,降,详,相,厢,像,巷,橡,香,湘,项,象,翔
爱	碍,艾,隘	挨,矮,哎,哀,埃,唉,蔼
惹	若	热
愁	稠,酬,畴,筹,绸,仇	丑,臭,抽
愈	狱,预,语,欲,玉,御,吁,豫,喻,寓,誉,郁,浴,域,裕,育,尉,谷,芋,与,遇	隅,羽,雨,屿,宇,愉,于,迂,鱼,愚,予,榆,逾,淤,渔,娱,舆
慎	肾,甚,渗	绅,身,深,神,呻,信,伸,沈,审,婶,参,申
慌	荒	晃,惶,恍,谎,皇,凰,黄,幌,蝗,煌
愧	溃	亏,盔,傀,葵,魁,窥
搓	撮	挫,锉,错,措
搞	搅,稿	高,糕,告,篙,膏,羔
搪	塘,膛,堂,糖,唐,棠	烫,淌,汤,趟,倘,躺
搭	瘩,答	达,打,大
搬	班,扳,颁,般,斑	版,伴,办,板,拌,半,瓣,绊,扮
搏	舶,白,膊,驳,脖,泊,渤,荸,卜,博,柏,勃,伯,薄	跛,簸,播,拨,剥,玻,般,菠
搜		嗽
搔	骚,艘	嫂,扫
损	笋	孙
抢	将,呛,强,枪,腔,闯	囱,墙,撞,窗,床,幢,创,疮
摇	遥,谣,窑,淆,姚,肴,侥	邀,乐,咬,么,哟,舀,吆,钥,拗,耀,妖,夭,腰,药,要
捣	祷,导,岛,倒	蹈,到,叨,盗,刀,悼,道,稻
敬	径,境,竞,静,劲,净,靖,镜,竟	精,京,兢,晶,鲸,警,颈,更,阱,景,睛,荆,惊,经,井,茎
斟	侦,诊,真,珍,贞,榛,针	疹,枕,阵,镇,震,振
新	芯,薪,心,辛,锌,欣	衅,信,寻
暗	按,案,岸	俺,氨,安,鞍,庵
暇	下,夏,侠,辖,斜,狭,吓,匣,挟,峡,厦,霞,洽	虾,瞎
晕	蕴,运,韵,员,酝,孕	匀,云,陨,耘,允
会	慧,筷,绘,惠,悔,贿,讳,刽,毁,晦,块,诲,汇,秽,快,虫,溃	灰,恢,辉,茴,徽,回,蛔,挥,堕
榔	廊,琅,狼,郎	朗,浪
业	叶,谒,夜,咽,射,页	爷,冶,野,也,椰
楚	处,础,储	厨,触,橱,初,锄,雏,畜,出,除,矗
楷	岂,凯,慨	开,咳,揩
楔	泻,卸,懈,屉,蟹,谢,械,屑,契,骇,解	谐,协,邪,斜,些,鞋,血,胁,写,挟,携,歇
极	吉,借,及,吃,脊,唧,即,急,圾,级,寂,集,辑,嫉,击,疾,棘,籍	技,几,箕,其,稽,祭,冀,鸡,际,居,肌,寄,系,剂,继,机,忌,叽,讥,期,季,激,饥,记,济,绩,纪,妓,荠,计,积,既,基,己,鲫,骑,奇,挤,畸,迹,给
椰	爷	叶,谒,野,冶,咽,夜,射,也,页,业
概	溉,盖,钙,丐	该,改
杨	扬,羊,阳,洋	养,央,氧,样,鸯,漾,仰,殃,秧,痒
楞		冷
枫	疯,峰,风,蜂,讽,封,丰,锋	冯,奉,凤,逢,缝
榆	隅,愉,于,鱼,愚,予,逾,渔,娱,舆	狱,雨,屿,预,语,欲,玉,御,吁,愈,豫,羽,喻,寓,誉,郁,浴,域,裕,迂,淤,育,宇,尉,谷,芋,与,遇
楣	眉,霉,梅,媒,没,枚,煤,玫	媚,每,美,昧,妹
歇	些	泻,楔,写,骇,解,谐,卸,谢,携,协,斜,械,蟹,胁,屑,邪,屉,懈,鞋,血,挟,契
岁	穗,碎,遂,祟,隧	髓,随,虽
毁	悔,贿,会,诲,虫	慧,绘,堕,惠,灰,讳,恢,汇,晦,辉,徽,茴,溃,蛔,秽,挥,回
殿	惦,佃,淀,电,店,垫,奠,玷,甸	颠,碘,典,点
溢	掖,衣,忆,肄,易,屹,一,亿,意,艺,邑,义,绎,议,毅,亦,译,益,逸,翼,奕,液,役,谊,艾,腋,抑,疫,异	已,乙,疑,倚,医,揖,夷,移,矣,遗,宜,尾,椅,蛇,漪,姨,壹,以,依,胰,仪,伊,蚁
溯	肃,速,宿,素,诉,塑,缩,粟	酥,俗,苏
滓	紫,仔,子,籽	吱,资,字,自,滋,姿,咨
溶	蓉,绒,融,熔,容,茸,榕,荣	冗
源	援,缘,猿,辕,员,园,袁,圆,原,元	宛,远,怨,愿,院,冤,渊,鸳
沟	句,勾,钩	苟,狗,购,够,构,垢
灭	蔑	
溺	逆,腻,匿,泥	你,呢,拟,尼
温	瘟	紊,纹,问,文,蚊,免,闻,吻,稳
滑	凸,古,划,桦,华,猾,豁,谷,骨,股,鼓,哗,贾	话,雇,化,沽,告,故,固,咕,估,画,顾,花,家,姑,孤,辜
溜	陆,馏,六	留,瘤,刘,流,榴,铆,琉,柳,硫,泵
沧	舱,仓,苍	藏
滔	涛,掏	逃,桃,套,讨,萄,陶,淘
溪	希,柒,吸,行,戚,稀,牺,膝,熙,犀,携,欺,西,悉,晰,漆,栖,嬉,蟋,七,厘,析,妻,凄,畦	息,气,习,启,起,鳍,稽,其,崎,枝,席,弃,旗,锡,隙,脐,只,系,迄,器,媳,泣,戏,洗,熄,祈,期,乞,砌,惜,喜,企,歧,昔,棋,细,夕,徙,骑,奇,契,汽,岂,袭,齐
煎	肩,歼,艰,奸,渐,监,间,溅,坚,兼,尖	箭,见,拣,减,剪,建,捡,件,贱,键,践,鉴,俭,碱,舰,茧,检,简,柬,健,荐,剑,涧
烟	燕,咽,奄,殷,厌,淹	掩,咽,艳,盐,炎,堰,延,癌,衍,颜,沿,砚,阎,眼,焰,演,雁,验,宴,严,研,谚,言,唁
烦	矾,凡,樊,繁,帆	犯,泛,饭,番,贩,翻,范,反,返
煤	眉,霉,梅,媒,楣,没,枚,玫	媚,每,美,昧,妹
炼	恋,练,链,敛	怜,脸,联,廉,莲,连,帘,镰
照	赵,罩,兆,召	沼,招,着,朝,昭,找,爪,嘲
煌	惶,皇,凰,黄,蝗	恍,谎,幌,慌,晃,荒
焕	痪,幻,涣,唤,宦,患,换	环,还,缓,欢
煞	霎,沙,杀,砂,厦,纱,杉	傻
爷	椰	叶,谒,野,冶,咽,夜,射,也,页,业
狮	失,尸,诗,虱,师,施,湿	拾,石,恃,提,射,誓,侍,适,始,饰,嗜,士,十,式,拭,屎,事,示,室,释,识,市,使,矢,什,世,驶,匙,势,实,史,食,硕,是,氏,视,蚀,柿,逝,时,试
猿	援,缘,源,辕,员,园,袁,圆,原,元	宛,远,怨,愿,院,冤,渊,鸳
猾	滑,划,桦,华,豁,哗	化,花,话,画
瑟	圾,涩,塞,色	
瑞	锐	蕊
当	铛,裆,挡,荡	党,档,挡,荡
畸	期,唧,激,饥,几,绩,箕,居,肌,讥,其,稽,奇,机,积,鸡,迹,叽,基	吉,吃,技,即,圾,集,祭,冀,嫉,籍,借,脊,际,级,寂,寄,系,剂,继,忌,击,极,季,记,济,纪,妓,辑,计,疾,既,及,己,急,给,鲫,骑,挤,棘,荠
痰	谈,昙,潭,坛,谭,弹,檀	叹,碳,坦,瘫,袒,贪,滩,摊,探,炭,毯
盏	崭,展,斩	占,毡,站,战,颤,暂,瞻,蘸,栈,沾,绽
盟	朦,檬,蒙,萌	孟,梦,锰,猛
睛	精,京,兢,晶,鲸,更,荆,惊,经,茎	径,境,竞,静,劲,净,警,靖,颈,阱,景,敬,镜,井,竟
睦	沐,牧,幕,募,慕,穆,暮,目,墓,木	姥,拇,牡,模,母,姆,亩
督	都	睹,牍,读,肚,渡,妒,毒,赌,度,镀,杜,独,堵
睹	赌,肚,堵	妒,牍,读,渡,毒,督,都,度,镀,杜,独
睬	彩,踩,采	材,裁,猜,财,菜,才
睁	怔,正,狰,争,丁,征,症,筝,挣,蒸	拯,政,郑,症,整,证
矮	蔼	挨,隘,艾,哎,埃,碍,爱,唉,哀
碎	穗,遂,祟,隧,岁	髓,随,虽
碰		捧,澎,蓬,彭,烹,棚,砰,硼,朋,篷,膨,鹏
碗	宛,挽,婉,晚,娩	弯,惋,丸,完,顽,万,腕,湾,豌,玩
碘	典,点	颠,惦,佃,淀,殿,电,店,垫,奠,玷,甸
碌	路,鹿,氯,陆,露,赂,录	卢,炉,芦,庐,卤,颅,鲁,虏
碉	叼,雕,刁	吊,调,钓,掉
硼	澎,蓬,彭,棚,朋,篷,膨,鹏	捧,碰,烹,砰
碑	背,悲,卑,杯	辈,北,备,贝,狈,惫,焙,臂,倍,被
禁	津,巾,近,仅,尽,晋,襟,劲,进,金,筋,今,浸,斤	谨,紧,锦
万	腕,玩,惋	弯,宛,挽,婉,碗,丸,完,顽,湾,晚,豌,娩
禽	勤,秦,芹,擒,琴	亲,寝,侵,钦
稚	质,知,挚,识,秩,制,帜,志,窒,智,治,置,滞,致,至	植,汁,蜘,织,吱,旨,直,值,芝,枝,职,殖,只,之,趾,指,止,纸,脂,氏,执,支,肢,掷,址,征
稠	酬,愁,畴,筹,绸,仇	丑,臭,抽
禀	屏,丙,饼,秉,柄	兵,病,冰,并
窟	哭,枯	酷,裤,苦,库
筷	刽,块,会,快	
节	结,洁,劫,捷,截,竭,杰	借,界,街,诫,揭,皆,阶,解,介,芥,接,姊,届,戒,姐
粱	粮,良,凉,量,梁	晾,俩,两,亮,谅,辆
粤	乐,越,悦,钥,跃,月,耀,阅,岳,药,说	约
经	精,京,兢,晶,鲸,更,睛,荆,惊,茎	径,境,竞,静,劲,净,警,靖,颈,阱,景,敬,镜,井,竟
绢	圈,倦,卷,眷	捐,鹃,身
绑	膀,榜	梆,邦,傍,蚌,帮,磅,棒,谤,旁
置	质,知,挚,识,秩,制,帜,志,窒,智,治,滞,稚,致,至	植,汁,蜘,织,吱,旨,直,值,芝,枝,职,殖,只,之,趾,指,止,纸,脂,氏,执,支,肢,掷,址,征
罩	赵,照,兆,召	沼,招,着,朝,昭,找,爪,嘲
罪	醉,最	嘴,堆
署	鼠,薯,竖,述,漱,数,蜀,暑,疏,曙,束,恕,属,树,墅,术,庶,黍	枢,抒,熟,梳,书,叔,淑,舒,蔬,赎,殊,输
义	掖,衣,忆,溢,肄,易,屹,一,亿,意,艺,邑,绎,议,毅,亦,译,益,逸,翼,奕,液,役,谊,艾,腋,抑,疫,异	已,乙,疑,倚,医,揖,夷,移,矣,遗,宜,尾,椅,蛇,漪,姨,壹,以,依,胰,仪,伊,蚁
群	裙	
圣	剩,乘,胜,盛	生,声,升,绳,甥,笙,省,牲
聘		濒,品,贫,拼,频
肆	伺,四,赐,食,饲,寺,似	私,撕,思,死,司,丝,斯,嘶
肄	掖,衣,忆,溢,易,屹,一,亿,意,艺,邑,义,绎,议,毅,亦,译,益,逸,翼,奕,液,役,谊,艾,腋,抑,疫,异	已,乙,疑,倚,医,揖,夷,移,矣,遗,宜,尾,椅,蛇,漪,姨,壹,以,依,胰,仪,伊,蚁
腰	邀,么,哟,吆,妖,夭,要	遥,乐,咬,谣,窑,舀,淆,钥,拗,姚,耀,肴,药,摇,侥
肠	尝,裳,长,场,常,偿	畅,唱,猖,厂,敞,倡,昌
腥	兴,猩,星	幸,型,刑,醒,邢,形,省,行,杏,性,姓
腮	塞	赛
脚	诀,倔,搅,缴,觉,掘,嚼,角,绝,决,矫,侥,狡,剿,较,饺,爵,绞	蕉,窖,教,焦,叫,椒,骄,交,校,郊,礁,浇,轿,胶,娇
肿	种	终,仲,忠,重,众,衷,盅,中,钟
腹	父,赋,复,附,咐,负,副,赴,富,妇,傅,付	甫,辐,符,麸,缚,服,扶,辅,夫,孵,肤,福,俘,浮,蝠,抚,幅,斧,腐,芙,袱,拂,脯,府,俯,敷,伏
腺	宪,现,限,馅,县,陷,献,线	贤,险,先,闲,涎,掀,嫌,铣,鲜,衔,弦,纤,舷,显,癣,仙,咸
脑	恼	闹,挠
舅	旧,救,疚,臼,究,就	酒,韭,鸠,久,灸,九,揪,玖,纠
艇	挺	亭,蜓,厅,庭,听,停,廷
蒂	缔,的,第,帝,地,递,弟	涤,嘀,嫡,低,滴,抵,笛,芽,底,敌
荤	婚,昏	浑,魂,混
落	辣,烙,络,腊,蜡,骆,酪,洛	罗,螺,萝,骡,箩,逻,喇,裸,锣,拉,啦
葵	魁	窥,亏,盔,愧,傀,溃
苇	萎,纬,委,伟,尾	威,谓,巍,魏,味,未,围,喂,遗,畏,胃,薇,位,为,微,伪,桅,维,偎,慰,尉,唯,卫,违,蔚,危
葫	糊,壶,胡,蝴,湖,狐,弧	护,许,乎,唬,沪,虎,互,戏,呼,户,忽
叶	社,拾,谒,设,咽,夜,舍,射,涉,摄,页,业,赦	蛇,野,爷,冶,舍,什,也,奢,舌,甚,椰,赊
葬	脏,藏	脏,赃
葛	格,阁,合,隔,革,蛤	个,搁,戈,胳,鸽,各,疙,割,哥,歌
葡	朴,脯,菩,仆,蒲	瀑,暴,普,圃,谱,铺,扑,浦,仆
董	懂	东,冻,动,洞,栋,冬
虏	鲁,卤	路,卢,鹿,碌,炉,氯,芦,陆,庐,颅,露,赂,录
号	镐,耗,嚎,壕,豪,浩,好,毫,鹤	蒿
蛹	咏,踊,泳,勇,永,拥	庸,用,佣
蜓	亭,停,廷,庭	听,厅,挺,艇
蜈	无,梧,巫,亡,吴,诬,芜	屋,武,于,物,误,污,侮,勿,呜,舞,五,乌,坞,务,雾,晤,鹉,午,捂,恶,悟,伍
蜀	鼠,薯,数,暑,属,署,黍	树,赎,述,梳,束,恕,蔬,输,疏,抒,竖,书,曙,淑,墅,术,庶,枢,漱,熟,叔,舒,殊
蛾	鹅,额,俄,讹	噩,哑,阿,遏,恶,饿,愕,鳄,扼
蜕	说,睡,税,退	腿,水,谁,颓,推
蜂	疯,峰,风,讽,封,丰,枫,锋	冯,奉,凤,逢,缝
衙	押,涯,蚜,牙,芽	哑,压,雅,轧,讶,呀,鸦,亚,鸭
裙	群	
补	哺,捕,卜	埠,怖,部,步,不,布,簿
装	妆,桩,庄	状,撞,壮
裕	狱,预,语,欲,玉,御,愈,吁,豫,喻,寓,誉,郁,浴,域,育,尉,谷,芋,与,遇	隅,羽,雨,屿,宇,愉,于,迂,鱼,愚,予,榆,逾,淤,渔,娱,舆
解	借,界,泻,诫,卸,懈,屉,姐,械,蟹,介,楔,谢,屑,芥,契,姊,届,戒,骇	街,皆,写,接,节,洁,谐,结,捷,些,截,竭,携,揭,协,斜,胁,歇,邪,阶,劫,鞋,血,挟,杰
该		改,丐,钙,盖,概,溉
详	祥,翔,降	响,向,镶,箱,享,乡,想,厢,相,像,巷,橡,香,湘,项,象
试	恃,适,誓,侍,饰,嗜,士,式,拭,事,示,室,释,识,市,使,世,势,是,氏,视,柿,逝	拾,石,提,失,射,始,虱,十,屎,尸,矢,什,驶,匙,实,史,食,师,硕,湿,蚀,狮,诗,时,施
诗	失,尸,狮,虱,师,施,湿	拾,石,恃,提,射,誓,侍,适,始,饰,嗜,士,十,式,拭,屎,事,示,室,释,识,市,使,矢,什,世,驶,匙,势,实,史,食,硕,是,氏,视,蚀,柿,逝,时,试
诚	澄,呈,橙,惩,承,成,程,乘,城,盛	撑,逞,秤,称
话	化,划,桦,华,画	滑,划,猾,豁,花,哗
诡	鬼,轨	规,瑰,闺,龟,柜,贵,桂,归,傀,跪
询	寻,驯,旬,巡,循	逊,讯,训,汛,殉,勋,迅
贼	则,择,泽,窄,责	怎,侧
资	姿,吱,滋,咨	紫,字,自,滓,籽,仔,子
贾	滑,稼,夏,凸,价,古,假,驾,架,谷,骨,甲,股,钾,鼓,嫁	荚,雇,夹,辜,沽,佳,告,茄,故,固,咕,估,顾,家,挟,姑,加,嘉,孤,颊
贿	慧,惠,悔,绘,讳,毁,晦,诲,会,汇,秽,虫,溃	灰,恢,辉,茴,徽,回,蛔,挥,堕
赁	刃,韧,纫,任,躏,认,吝	淋,临,磷,邻,琳,人,仁,忍,凛,鳞,林,儿
赂	路,鹿,碌,氯,陆,露,录	卢,炉,芦,庐,卤,颅,鲁,虏
迹	期,唧,激,饥,几,绩,箕,居,肌,讥,其,稽,奇,机,畸,积,鸡,叽,基	吉,吃,技,即,圾,集,祭,冀,嫉,籍,借,脊,际,级,寂,寄,系,剂,继,忌,击,极,季,记,济,纪,妓,辑,计,疾,既,及,己,急,给,鲫,骑,挤,棘,荠
跟	根	
跨	胯	夸,垮
路	鹿,碌,氯,陆,露,赂,录	卢,炉,芦,庐,卤,颅,鲁,虏
跳		条,调,挑
跺	惰,踱,舵,度,驮,堕	夺,朵,躲,多
跪	柜,贵,桂	规,鬼,诡,瑰,闺,龟,轨,归,傀
躲	朵	惰,踱,跺,多,夺,舵,驮,度,堕
较	窖,搅,教,叫,缴,觉,轿,狡,矫,侥,角,校,脚,剿,饺,绞	蕉,焦,椒,骄,嚼,交,郊,礁,浇,胶,娇
载	在,宰,仔,再	灾,栽
辟	闭,币,必,譬,毙,蔽,僻,毕,泌,避,璧,碧,比,壁,弊,臂,庇,鄙,屁	坏,疲,笔,霹,否,彼,脾,逼,啤,批,皮,罢,匕,劈,鼻,被,匹,披
农	浓,脓	弄
运	蕴,韵,员,酝,孕,晕	匀,云,陨,耘,允
道	蹈,导,到,盗,悼,倒,稻	祷,岛,叨,捣,刀
遂	穗,碎,祟,隧,岁	髓,随,虽
达	瘩,答	大,打,搭
逼		笔,彼,币,毙,蔽,比,毕,壁,臂,庇,闭,避,璧,鼻,辟,鄙,碧,泌,匕,弊,必
违	薇,唯,围,为,微,桅,巍,维,危	威,委,谓,魏,味,未,喂,遗,畏,伟,尾,胃,位,伪,偎,纬,慰,尉,萎,卫,苇,蔚
遇	狱,预,语,欲,玉,御,愈,吁,豫,喻,寓,誉,郁,浴,域,裕,育,尉,谷,芋,与	隅,羽,雨,屿,宇,愉,于,迂,鱼,愚,予,榆,逾,淤,渔,娱,舆
遏	噩,哑,俄,恶,饿,愕,鳄,扼	讹,鹅,额,蛾,阿
过		裹,果,国,锅,郭
遍	变,便,骗,辩,辫,辨,片	蝙,贬,边,编,偏,篇,鞭,扁,翩,匾
逾	隅,愉,于,榆,鱼,愚,予,渔,娱,舆	狱,雨,屿,预,语,欲,玉,御,吁,愈,豫,羽,喻,寓,誉,郁,浴,域,裕,迂,淤,育,宇,尉,谷,芋,与,遇
酬	稠,愁,畴,筹,仇,绸	丑,臭,抽
酪	烙,络,骆,落,劳,洛	萝,姥,螺,骡,箩,罗,逻,牢,裸,捞,锣,唠,老
钳	钱,黔,干,潜,前	浅,铅,千,遣,谴,嵌,迁,纤,牵,谦,签,歉,欠
钾	甲,贾,夏,假	稼,价,夹,佳,驾,茄,架,挟,嫁,嘉,加,荚,家,颊
铅	千,嵌,迁,纤,牵,谦,签	浅,钱,遣,谴,钳,黔,歉,欠,干,潜,前
钩	句,勾,沟	苟,狗,购,够,构,垢
铃	凌,玲,龄,零,菱,陵,翎,蛉,伶,灵	另,岭,领,令
铆	柳	留,瘤,刘,流,馏,榴,陆,琉,溜,硫,六,泵
闸	扎,炸	乍,喳,查,眨,诈,渣,栅
隘	艾,碍,爱	挨,矮,哎,哀,埃,唉,蔼
隔	格,葛,阁,合,革,蛤	个,搁,戈,胳,鸽,各,疙,割,哥,歌
陨	允	蕴,运,匀,云,韵,耘,员,酝,孕,晕
雷	擂,累	垒,勒,泪,类,蕾,儡
电	惦,佃,淀,殿,店,垫,奠,玷,甸	颠,碘,典,点
雹	薄	胞,暴,保,爆,褒,宝,苞,豹,饱,包,堡,抱,报,刨
零	铃,凌,玲,龄,菱,陵,翎,蛉,伶,灵	另,岭,领,令
靖	径,境,竞,静,劲,净,敬,镜,竟	精,京,兢,晶,鲸,警,颈,更,阱,景,睛,荆,惊,经,井,茎
靴	薛	雪,穴,血,削,学
靶	把	爸,捌,芭,笆,扒,坝,耙,拔,巴,罢,叭,八,疤,霸,跋,伯,吧
预	狱,语,欲,玉,御,愈,吁,豫,喻,寓,誉,郁,浴,域,裕,育,尉,谷,芋,与,遇	隅,羽,雨,屿,宇,愉,于,迂,鱼,愚,予,榆,逾,淤,渔,娱,舆
顽	完,玩,丸	弯,宛,挽,婉,碗,惋,万,腕,湾,晚,豌,娩
顿	盾,吨,钝,囤,盹	墩,蹲,敦
颁	班,扳,搬,般,斑	版,伴,办,板,拌,半,瓣,绊,扮
颂	送,讼,诵,宋	松,耸
饲	伺,四,肆,赐,食,寺,似	私,撕,思,死,司,丝,斯,嘶
饱	宝,保,堡	胞,薄,暴,爆,苞,雹,褒,豹,包,抱,报,刨
饰	恃,适,誓,侍,嗜,士,式,拭,事,示,室,释,识,市,使,世,势,是,氏,视,柿,逝,试	拾,石,提,失,射,始,虱,十,屎,尸,矢,什,驶,匙,实,史,食,师,硕,湿,蚀,狮,诗,时,施
驰	池,持,迟,匙,弛	吃,嗤,齿,侈,翅,斥,耻,赤,尺
驮	惰,堕,踱,跺,舵,鸵,度,驼	拖,躲,朵,托,多,夺,唾,脱,椭,妥,拓
驯	循,讯,训,寻,旬,巡,汛,询,殉,逊,迅	勋
鸠	纠,揪	酒,救,旧,疚,韭,臼,久,舅,灸,究,九,就,玖
鼎	顶	盯,定,订,钉,丁,锭,叮
鼓	滑,凸,古,谷,骨,股,贾	雇,沽,告,故,咕,固,估,顾,家,姑,孤,辜
鼠	薯,数,蜀,暑,属,署,黍	树,赎,述,梳,束,恕,蔬,输,疏,抒,竖,书,曙,淑,墅,术,庶,枢,漱,熟,叔,舒,殊
侥	遥,搅,谣,缴,窑,狡,淆,矫,角,姚,肴,脚,剿,较,饺,摇,绞	窖,乐,咬,焦,哟,交,腰,要,娇,蕉,么,钥,吆,拗,校,胶,叫,觉,椒,骄,嚼,耀,妖,夭,郊,轿,邀,教,舀,礁,浇,药
僚	辽,燎,聊,疗,缭,撩,嘹,寥,潦	了,料
像	向,乡,相,巷,橡,项,象	响,镶,享,箱,祥,想,详,厢,降,香,湘,翔
侨	乔,瞧,翘,桥,憔	峭,窍,壳,鹊,撬,雀,敲,巧,锹,悄,俏,跷
兢	精,京,晶,鲸,更,睛,荆,惊,经,茎	径,境,竞,静,劲,净,警,靖,颈,阱,景,敬,镜,井,竟
凳	瞪,邓,蹬	等,灯,登
厌	唁,燕,烟,咽,焰,奄,殷,艳,研,沿,谚,雁,砚,淹,验,堰,宴	延,癌,掩,阎,严,衍,眼,演,颜,盐,炎,言
嘀	涤,嫡,的,笛,芽,敌	低,缔,抵,第,蒂,帝,地,滴,递,底,弟
尝	裳,长,肠,场,常,偿	畅,唱,猖,厂,敞,倡,昌
嗽		搜
呕	藕,殴,偶,欧,区,鸥	
叹	探,碳,炭	谈,瘫,昙,袒,坦,贪,潭,痰,谭,坛,滩,摊,弹,檀,毯
嘉	夹,佳,茄,加,家	夏,稼,价,假,驾,架,甲,挟,钾,嫁,荚,贾,颊
图	屠,凸,涂,途,突,徒	秃,土,吐,兔
尘	陈,晨,忱,沈,臣,沉,辰	趁,称,衬
境	径,竞,静,劲,净,靖,敬,镜,竟	精,京,兢,晶,鲸,警,颈,更,阱,景,睛,荆,惊,经,井,茎
墓	沐,牧,幕,募,慕,睦,穆,暮,目,木	姥,拇,牡,模,母,姆,亩
垫	惦,佃,淀,殿,电,店,奠,玷,甸	颠,碘,典,点
墅	述,竖,漱,数,束,曙,恕,署,树,术,庶,疏	鼠,薯,抒,枢,熟,蜀,梳,暑,书,叔,淑,属,舒,蔬,赎,殊,输,黍
寿	瘦,售,授,受,兽	熟,手,首,守,收
梦	孟	蒙,盟,朦,锰,猛,檬,萌
夺	多	躲,朵,惰,踱,跺,舵,驮,度,堕
嫡	涤,嘀,的,笛,芽,敌	低,缔,抵,第,蒂,帝,地,滴,递,底,弟
孵	肤,夫,麸,敷	甫,辐,符,负,咐,复,缚,腹,辅,扶,妇,服,父,赋,福,俘,附,浮,蝠,付,抚,幅,斧,赴,腐,伏,芙,袱,拂,脯,府,俯,富,傅,副
寞	墨,末,默,莫,沫,磨,膜,没,漠,茉,脉,陌	么,蘑,摸,摹,魔,抹,摩,模
宁	狞,柠,凝,拧	泞
寡		括,瓜,褂,挂,刮,卦,蜗
寥	辽,燎,聊,疗,缭,撩,僚,嘹,潦	了,料
实	拾,石,提,什,蚀,射,时,硕,食,十	恃,失,适,誓,侍,始,虱,饰,嗜,士,式,拭,屎,事,示,室,尸,释,识,市,使,矢,世,驶,匙,势,史,师,是,湿,氏,视,狮,诗,柿,逝,施,试
寨	责,债,祭	宅,摘,窄,斋,齐
寝		禽,勤,钦,亲,秦,侵,芹,擒,琴
察	查,茶	插,叉,刹,差,喳,岔
对	队,兑	堆
屡	缕,旅,铝,侣,吕,履,娄	虑,滤,率,绿,氯,驴,律
崭	盏,展,斩	占,毡,站,战,颤,暂,瞻,蘸,栈,沾,绽
岖	圈,蛆,趋,驱,区,曲,躯,屈	取,漆,渠,娶,趣,去
币	闭,毙,蔽,碧,毕,泌,避,璧,比,壁,弊,臂,辟,庇,鄙,必	笔,彼,逼,匕,鼻
幕	沐,牧,募,慕,睦,穆,暮,目,墓,木	姥,拇,牡,模,母,姆,亩
幔	慢,曼,蔓,漫	满,瞒,蛮,馒
廓	括,阔,扩	
弊	闭,币,毙,蔽,碧,毕,泌,避,璧,比,壁,臂,辟,庇,鄙,必	笔,彼,逼,匕,鼻
彰	樟,章,张	胀,丈,掌,长,杖,涨,障,帐,仗,账
彻	撤,澈,辙	车,扯
愿	远,怨,院	援,宛,渊,缘,猿,辕,源,员,园,袁,冤,圆,原,鸳,元
态	汰,泰,太	台,抬,胎,苔
慷	康,糠	炕,抗,扛
慢	曼,蔓,漫,幔	满,瞒,蛮,馒
惯	冠,观,罐,灌,贯	关,馆,棺,管,官
惭	残,蚕	灿,餐,惨,参
惨		蚕,餐,残,灿,参,惭
截	结,洁,劫,捷,竭,杰,节	借,界,街,诫,揭,皆,阶,解,介,芥,接,姊,届,戒,姐
摘	斋,哲,折,辙,齐	寨,这,债,着,宅,浙,遮,窄,祭,蔗,者,责
摔	衰	率,甩,帅,蟀
撤	澈,辙,彻	车,扯
摸		墨,末,寞,默,莫,蘑,么,磨,沫,茉,膜,摹,没,魔,抹,摩,模,漠,脉,陌
搂	篓	漏,楼,陋,露,娄
摧	催,衰,崔	脆,翠,粹,悴
掺	搀	阐,缠,馋,产,铲,单,蝉
敲	锹,跷,撬	峭,瞧,乔,窍,壳,鹊,桥,雀,巧,侨,翘,悄,俏,憔
旗	祈,期,棋,脐,只,崎,鳍,奇,其,骑,歧,畦,枝,齐	气,启,起,柒,稽,戚,弃,溪,迄,器,泣,欺,漆,砌,乞,栖,七,凄,妻,契,汽,岂,企
畅	倡,唱	尝,长,猖,裳,肠,厂,敞,场,常,偿,昌
榜	膀,绑	梆,邦,傍,蚌,帮,磅,棒,谤,旁
榕	蓉,绒,融,熔,容,茸,溶,荣	冗
荣	蓉,绒,融,熔,容,茸,榕,溶	冗
构	购,够,垢	苟,沟,狗,句,勾,钩
榛	侦,诊,真,珍,贞,斟,针	疹,枕,阵,镇,震,振
榴	留,瘤,刘,流,琉,硫,泵	馏,陆,铆,柳,溜,六
槐	怀,徊,淮	坏
枪	将,抢,腔,呛	墙,强
歉	纤,欠	浅,钱,铅,千,遣,谴,钳,嵌,迁,黔,牵,谦,签,干,潜,前
歌	搁,戈,胳,鸽,疙,割,哥	个,格,葛,阁,合,各,隔,革,蛤
演	掩,眼,衍	咽,艳,盐,炎,堰,延,癌,颜,沿,砚,阎,焰,奄,殷,雁,验,宴,燕,严,烟,研,厌,谚,言,唁,淹
滚		棍
漓	丽,璃,厘,离,篱,梨,犁,狸,黎	立,砾,痢,俐,鲤,沥,哩,隶,励,粒,李,里,厉,雳,历,荔,栗,利,力,理,莉,例,吏,礼
滴	低	涤,嘀,嫡,敌,缔,抵,蒂,笛,的,第,帝,地,芽,递,底,弟
漩	悬,炫,还,玄,县,旋	选,喧,轩,宣
漾	养,样	央,杨,阳,氧,扬,鸯,羊,仰,殃,秧,痒,洋
漠	墨,末,寞,默,沫,莫,磨,膜,没,茉,脉,陌	么,蘑,摸,摹,魔,抹,摩,模
漏	露,陋	搂,篓,娄,楼
漂	飘,票	瓢
汉	悍,焊,憾,翰,旱,撼,汗,捍	韩,喊,罕,函,酣,含,寒,和,涵
满		曼,蔓,幔,蛮,慢,馒,瞒,漫
滞	质,知,挚,识,秩,制,帜,志,窒,智,置,治,稚,致,至	植,汁,蜘,织,吱,旨,直,值,芝,枝,职,殖,只,之,趾,指,止,纸,脂,氏,执,支,肢,掷,址,征
漆	溪,凄,妻,栖,娶,趣,柒,去,七,戚,欺	圈,趋,气,启,起,鳍,稽,其,崎,区,枝,躯,弃,旗,脐,只,迄,驱,器,泣,屈,祈,期,乞,砌,企,歧,岖,蛆,取,棋,渠,骑,奇,契,畦,汽,岂,曲,齐
漱	述,竖,数,束,曙,恕,署,树,墅,术,庶,疏	鼠,薯,抒,枢,熟,蜀,梳,暑,书,叔,淑,属,舒,蔬,赎,殊,输,黍
渐	箭,见,建,歼,艰,煎,件,贱,键,践,鉴,舰,肩,监,间,坚,尖,健,荐,剑,奸,涧,溅,兼	碱,茧,拣,减,剪,检,简,俭,捡,柬
涨	胀,丈,掌,长,杖,障,帐,仗,账	彰,樟,章,张
漫	曼,蔓,幔,蛮,慢,馒,瞒	满
澈	撤,辙,彻	车,扯
漪	依,医,揖,衣,伊,壹,一	掖,已,乙,忆,溢,易,肄,疑,倚,屹,亿,一,意,艺,议,邑,义,绎,毅,夷,移,矣,遗,亦,译,宜,益,尾,椅,蛇,逸,翼,奕,姨,液,役,以,谊,胰,艾,仪,蚁,抑,疫,异,腋
沪	护,户,互	糊,戏,壶,胡,许,乎,蝴,唬,葫,虎,湖,狐,呼,忽,弧
渔	隅,愉,于,榆,鱼,愚,逾,予,娱,舆	狱,雨,屿,预,语,欲,予,御,吁,愈,豫,羽,喻,寓,誉,郁,浴,域,裕,迂,淤,育,宇,尉,谷,芋,与,遇
渗	肾,甚,慎	绅,身,深,神,呻,信,伸,沈,审,婶,参,申
涤	嘀,嫡,的,笛,芽,敌	低,缔,抵,第,蒂,帝,地,滴,递,底,弟
熔	蓉,绒,融,容,茸,榕,溶,荣	冗
熙	西,悉,希,晰,溪,厘,析,稀,栖,牺,嬉,膝,犀,吸,蟋,行,携,畦	席,息,习,昔,锡,喜,惜,细,夕,隙,系,徙,熄,媳,袭,洗,戏
熊	雄	凶,胸,汹,兄,匈
熄	席,息,习,锡,昔,惜,媳,袭	希,吸,行,溪,稀,隙,牺,系,膝,熙,犀,携,戏,洗,西,悉,晰,喜,栖,嬉,蟋,厘,析,细,夕,徙,畦
荧	萤,赢,迎,蝇,营,盈,莹	影,莺,鹰,婴,应,硬,英,缨,景,鹦,樱,映,颖
尔	儿,耳,饵	贰,而,儿,二
狱	预,语,欲,玉,御,愈,吁,豫,喻,寓,誉,郁,浴,域,裕,育,尉,谷,芋,与,遇	隅,羽,雨,屿,宇,愉,于,迂,鱼,愚,予,榆,逾,淤,渔,娱,舆
琐	所,锁,索	嗦,缩,唆,梭
玛	码,马,蚂,吗	么,麻,妈,骂,蟆
瑰	规,闺,龟,归,傀	鬼,柜,贵,桂,轨,跪,诡
疑	谊,蛇,胰,仪,夷,移,遗,姨,宜,一	掖,已,乙,衣,忆,溢,易,肄,倚,屹,亿,意,艺,议,邑,义,医,绎,揖,毅,矣,亦,译,益,尾,椅,逸,翼,漪,奕,液,役,壹,以,依,艾,伊,蚁,抑,疫,异,腋
疟	虐	
疯	峰,风,蜂,讽,封,丰,枫,锋	冯,奉,凤,逢,缝
痪	焕,幻,涣,唤,宦,患,换	环,还,缓,欢
尽	近,浸,晋,仅,劲,锦,进,谨,禁,紧	津,巾,襟,锦,筋,金,谨,今,紧,斤
监	箭,见,建,歼,艰,煎,件,贱,键,践,鉴,舰,肩,渐,间,坚,尖,健,荐,剑,奸,涧,溅,兼	碱,茧,拣,减,剪,检,简,俭,捡,柬
瞄	描,苗	渺,秒,妙,藐,庙
睡	说,税,蜕	水,谁
磁	词,雌,辞,慈,祠,瓷	此,伺,刺,次,差,赐,厕
碟	蝶,跌,谍,叠	爹
碧	闭,币,毙,蔽,比,毕,泌,避,璧,壁,弊,臂,辟,庇,鄙,必	笔,彼,逼,匕,鼻
碳	探,叹,炭	谈,瘫,昙,袒,坦,贪,潭,痰,谭,坛,滩,摊,弹,檀,毯
硕	率,拾,帅,蟀,数,石,烁,提,勺,什,射,蚀,时,实,食,十	恃,失,适,誓,侍,始,虱,饰,嗜,士,说,式,拭,屎,事,示,室,尸,释,识,市,使,矢,世,驶,匙,势,史,师,是,湿,氏,视,狮,诗,柿,逝,施,试
福	袱,幅,拂,辐,俘,符,服,浮,蝠,缚,扶,夫,伏,芙	甫,复,麸,负,咐,腹,妇,辅,孵,父,肤,赋,附,付,抚,斧,赴,腐,脯,府,俯,敷,富,傅,副
祸	霍,豁,惑,货,获,或	活,火,和,伙
种	仲,重,众,肿,中	终,忠,衷,盅,钟
称	撑,秤,趁,衬	澄,呈,陈,晨,橙,尘,沈,忱,逞,成,惩,承,程,乘,臣,沉,城,辰,盛,诚
洼	挖,蛙	袜,瓦,娃
窝	涡	握,沃,我,卧
竭	洁,结,劫,捷,截,杰,节	借,界,街,诫,揭,皆,阶,解,介,芥,接,姊,届,戒,姐
端		缎,锻,短,段,断
管	馆	冠,观,罐,关,棺,灌,贯,官,惯
箕	期,唧,激,饥,几,绩,居,肌,讥,其,稽,奇,机,畸,积,鸡,迹,叽,基	吉,吃,技,即,圾,集,祭,冀,嫉,籍,借,脊,际,级,寂,寄,系,剂,继,忌,击,极,季,记,济,纪,妓,辑,计,疾,既,及,己,急,给,鲫,骑,挤,棘,荠
算	蒜	酸
筝	怔,正,狰,睁,争,丁,征,症,挣,蒸	拯,政,郑,症,整,证
粹	脆,翠,悴	催,摧,衰,崔
精	京,兢,晶,鲸,更,睛,荆,惊,经,茎	径,境,竞,静,劲,净,警,靖,颈,阱,景,敬,镜,井,竟
绽	占,站,战,颤,暂,蘸,栈	毡,斩,盏,展,崭,瞻,沾
综	从,棕,宗,踪,纵	总
绰		戳
绿	虑,滤,率,氯,律	缕,旅,铝,侣,吕,驴,娄,履,屡
紧	谨,仅,尽,锦	津,巾,近,晋,尽,襟,劲,进,金,筋,禁,今,浸,斤
缀	坠,赘	追,锥,椎
网	往,枉	忘,旺,汪,妄,亡,望,王
纲	肛,岗,刚,钢,冈,扛,缸	港
绸	稠,酬,愁,畴,筹,仇	丑,臭,抽
绵	棉,眠	冕,免,面,勉,缅,娩
维	薇,唯,违,围,为,微,桅,巍,危	威,委,谓,魏,味,未,喂,遗,畏,伟,尾,胃,位,伪,偎,纬,慰,尉,萎,卫,苇,蔚
绪	叙,絮,旭,酗,婿,蓄,续,畜,恤,序	徐,吁,需,须,许,虚
罚	法,筏,阀,伐,乏	发
翠	脆,粹,悴	催,摧,衰,崔
闻	紊,纹,问,文,蚊,免	温,吻,稳,瘟
聚	拒,足,惧,炬,俱,据,锯,句,巨,具,距,剧	菊,蛆,沮,居,橘,车,鞠,矩,举,局,驹,拘
腐	甫,抚,父,斧,府,脯,俯,辅	辐,符,麸,负,咐,复,副,缚,腹,服,扶,妇,夫,孵,肤,赋,福,俘,附,浮,蝠,付,幅,赴,芙,袱,拂,敷,富,傅,伏
膀	螃,庞,榜,旁,绑	梆,邦,傍,蚌,帮,胖,磅,棒,谤,乓
膏	高,糕,篙,羔	搅,搞,告,稿
膊	舶,白,驳,搏,脖,泊,渤,荸,卜,博,柏,勃,伯,薄	跛,簸,播,拨,剥,玻,般,菠
腿		蜕,退,颓,推
与	狱,雨,屿,预,语,欲,予,玉,御,吁,愈,豫,羽,喻,寓,誉,郁,域,浴,裕,育,宇,尉,谷,芋,遇	隅,愉,于,迂,榆,鱼,逾,渔,愚,淤,娱,舆
舔		甜,田,天,填,添,恬
舞	侮,武,鹉,午,五,捂,伍	屋,于,诬,芜,物,误,污,勿,呜,无,吴,乌,坞,梧,务,蜈,雾,晤,巫,亡,恶,悟
蓉	绒,融,熔,容,茸,榕,溶,荣	冗
蒿		镐,耗,嚎,壕,豪,浩,好,号,毫,鹤
蓄	叙,絮,旭,绪,酗,婿,续,畜,恤,序	徐,吁,需,须,许,虚
蒙	萌,檬,朦,盟	孟,锰,梦,猛
蒲	朴,脯,菩,葡,仆	瀑,暴,普,圃,谱,铺,扑,浦,仆
蒜	算	酸
盖	盒,丐,概,何,禾,核,荷,合,褐,钙,和,河,溉	喝,改,呵,吓,该,赫,贺,鹤
蒸	怔,正,狰,睁,争,丁,征,症,筝,挣	拯,政,郑,症,整,证
苍	舱,仓,沧	藏
蜜	密,觅,秘,泌	咪,谜,弥,糜,迷,靡,米
蜻	顷,青,卿,轻,清,氢,倾	晴,亲,庆,情,请,擎
蜘	吱,汁,织,支,肢,知,只,之,脂,芝,枝,氏	植,旨,直,值,置,滞,治,至,职,秩,殖,帜,智,趾,致,识,指,质,止,挚,窒,纸,稚,执,掷,制,址,志,征
蚀	拾,石,提,射,什,食,实,硕,时,十	恃,失,适,誓,侍,始,虱,饰,嗜,士,式,拭,屎,事,示,室,尸,释,识,市,使,矢,世,驶,匙,势,史,师,是,湿,氏,视,狮,诗,柿,逝,施,试
裳	尝,长,肠,场,常,偿	畅,赏,商,唱,猖,汤,晌,伤,厂,敞,上,倡,尚,昌
褂	挂,卦	括,瓜,刮,寡,蜗
裹	果	过,国,锅,郭
裸		罗,螺,萝,骡,箩,洛,烙,逻,络,骆,锣,落,酪
诵	送,讼,宋,颂	松,耸
语	狱,雨,屿,预,欲,予,玉,御,吁,愈,豫,羽,喻,寓,誉,郁,域,浴,裕,育,宇,尉,谷,芋,与,遇	隅,愉,于,迂,榆,鱼,逾,渔,愚,淤,娱,舆
诬	污,屋,呜,于,无,巫,亡,梧,蜈,恶,吴,芜,乌	晤,误,悟,坞,侮,武,勿,鹉,舞,午,五,捂,务,物,雾,伍
认	刃,韧,纫,任,赁	人,仁,儿,忍
诫	借,界,介,芥,届,戒,解	街,结,揭,皆,阶,洁,杰,劫,捷,截,竭,接,姊,节,姐
誓	恃,适,侍,饰,嗜,士,式,拭,事,示,室,释,识,市,使,世,势,是,氏,视,柿,逝,试	拾,石,提,失,射,始,虱,十,屎,尸,矢,什,驶,匙,实,史,食,师,硕,湿,蚀,狮,诗,时,施
误	晤,坞,勿,务,恶,悟,雾,物	屋,武,于,芜,污,侮,呜,无,舞,五,吴,乌,梧,蜈,鹉,午,巫,亡,捂,诬,伍
说	乐,越,悦,钥,跃,税,月,耀,蜕,阅,粤,岳,药,睡	率,约,帅,数,蟀,烁,水,谁,勺,硕
诲	慧,惠,悔,绘,贿,讳,毁,晦,会,汇,秽,虫,溃	灰,恢,辉,茴,徽,回,蛔,挥,堕
诱	佑,又,幼,右,有	优,由,犹,油,幽,悠,游,忧,尤,邮,友
豪	嚎,壕,号,毫,鹤	镐,耗,浩,好,蒿
貌	冒,贸,帽,茂	矛,毛,猫,锚,茅
宾	濒,缤,滨,彬	鬓
赊	奢	社,蛇,拾,叶,设,舍,什,射,涉,摄,舌,甚,赦
赫	喝,吓,荷,和,贺,鹤	盒,呵,何,禾,核,合,褐,盖,河
赵	罩,照,兆,召	沼,招,着,朝,昭,找,爪,嘲
赶	敢,感,秆,橄,杆	柑,杆,竿,甘,肝,干
辅	父,抚,甫,斧,府,脯,俯,腐	辐,符,麸,负,咐,复,副,缚,腹,服,扶,妇,夫,孵,肤,赋,福,俘,附,浮,蝠,付,幅,赴,芙,袱,拂,敷,富,傅,伏
轻	顷,青,蜻,卿,氢,清,倾	晴,亲,庆,情,请,擎
辣	落,腊,蜡	喇,拉,啦
远	怨,院,愿	袁,援,宛,缘,源,猿,辕,员,园,渊,冤,圆,原,鸳,元
逊	讯,训,驯,汛,殉,迅	寻,旬,巡,询,循,勋
遣	谴,浅	钱,铅,千,钳,嵌,迁,黔,纤,歉,牵,谦,签,欠,干,潜,前
遥	谣,窑,淆,姚,肴,摇,侥	邀,乐,咬,么,哟,舀,吆,钥,拗,耀,妖,夭,腰,药,要
递	缔,的,第,蒂,帝,地,弟	涤,嘀,嫡,低,滴,抵,笛,芽,底,敌
鄙	闭,笔,币,毙,蔽,彼,比,毕,泌,避,璧,碧,匕,弊,臂,辟,壁,庇,必	逼,鼻
酵	啸,校,孝,效,肖,笑	哮,小,销,萧,嚣,削,硝,宵,箫,学,消,晓
酸		蒜,算
酷	库,裤	窟,枯,哭,苦
银	淫,吟	因,隐,姻,音,瘾,引,殷,印,听,蚓,茵,阴,饮
铜	桐,彤,童,瞳,同	筒,通,统,痛,桶
铭	明,鸣,名,螟	命
衔	贤,闲,涎,嫌,弦,舷,咸	腺,宪,馅,先,掀,现,铣,鲜,纤,癣,限,显,县,陷,仙,献,险,线
铣	险,癣,鲜,显	宪,先,闲,嫌,现,限,陷,咸,线,弦,馅,腺,衔,县,献,贤,涎,掀,纤,舷,仙
闺	规,瑰,龟,归,傀	鬼,柜,贵,桂,轨,跪,诡
闽	皿,悯,敏	民
阁	格,葛,合,隔,革,蛤	个,搁,戈,胳,鸽,各,疙,割,哥,歌
阀	法,筏,伐,乏,罚	发
隙	戏,细,夕,系	息,希,习,吸,行,席,溪,锡,稀,牺,膝,熙,犀,携,媳,洗,熄,西,悉,晰,喜,惜,栖,嬉,蟋,厘,析,昔,徙,畦,袭
障	胀,丈,长,杖,涨,帐,仗,账	樟,掌,张,彰,章
际	计,技,季,记,济,纪,妓,寄,系,鲫,剂,骑,继,忌,祭,冀,既,荠	吉,吃,即,几,圾,箕,其,稽,集,嫉,鸡,籍,借,脊,级,居,寂,肌,机,叽,击,讥,极,期,唧,激,饥,绩,辑,积,疾,基,及,己,急,奇,挤,畸,棘,迹,给
雌	词,磁,辞,差,慈,祠,瓷	此,伺,刺,次,赐,厕
需	须,虚,吁	徐,叙,絮,旭,绪,酗,婿,蓄,续,畜,恤,序,许
颇	剖	迫,坡,魄,破,泊,婆,朴,波,泼
领	岭	铃,玲,凌,龄,零,菱,陵,翎,另,令,蛉,伶,灵
飒	萨	撒,洒
饺	搅,缴,狡,矫,侥,角,脚,剿,较,绞	窖,蕉,教,焦,叫,觉,椒,骄,嚼,交,校,郊,礁,浇,轿,胶,娇
饼	屏,丙,禀,秉,柄	兵,病,冰,并
饵	尔,耳	贰,而,儿,二
驳	舶,白,膊,搏,脖,泊,渤,荸,卜,博,柏,勃,伯,薄	跛,簸,播,拨,剥,玻,般,菠
肮		昂
魁	葵	窥,亏,盔,愧,傀,溃
魂	浑,混	婚,荤,昏
鸣	明,名,铭,螟	命
凤	讽,缝,奉	冯,疯,枫,峰,风,蜂,封,丰,逢,锋
鼻		笔,彼,币,毙,蔽,比,毕,壁,臂,庇,闭,逼,避,璧,辟,鄙,碧,泌,匕,弊,必
齐	祈,期,旗,棋,斋,脐,摘,崎,鳍,其,只,骑,歧,奇,畦,枝	气,启,起,柒,稽,祭,责,戚,弃,溪,债,宅,迄,器,泣,欺,漆,砌,乞,栖,七,寨,凄,妻,窄,契,汽,岂,企
亿	掖,衣,忆,溢,肄,易,屹,一,意,艺,邑,义,绎,议,毅,亦,译,益,逸,翼,奕,液,役,谊,艾,腋,抑,疫,异	已,乙,疑,倚,医,揖,夷,移,矣,遗,宜,尾,椅,蛇,漪,姨,壹,以,依,胰,仪,伊,蚁
仪	谊,蛇,胰,夷,移,遗,姨,疑,宜,一	掖,已,乙,衣,忆,溢,易,肄,倚,屹,亿,意,艺,议,邑,义,医,绎,揖,毅,矣,亦,译,益,尾,椅,逸,翼,漪,奕,液,役,壹,以,依,艾,伊,蚁,抑,疫,异,腋
僻	譬,辟,屁	坏,霹,疲,否,脾,啤,批,罢,皮,劈,被,匹,披
僵	将,浆,疆,姜,江,缰	奖,强,桨,酱,蒋,降,匠,讲
价	稼,假,驾,架,嫁,贾	夏,夹,佳,轧,茄,甲,挟,钾,嘉,加,荚,家,颊
俭	碱,茧,拣,减,剪,检,简,捡,柬	箭,见,建,歼,艰,煎,件,贱,键,践,鉴,舰,肩,渐,监,间,坚,尖,健,荐,剑,奸,涧,溅,兼
凛		淋,临,磷,邻,琳,躏,鳞,林,吝,赁
剧	拒,足,惧,炬,俱,据,聚,锯,句,巨,具,距	菊,蛆,沮,居,橘,车,鞠,矩,举,局,驹,拘
劈	坏,霹,批,被,匹,披	疲,譬,否,罢,啤,脾,皮,僻,辟,屁
刘	留,瘤,流,榴,琉,硫,泵	馏,陆,铆,柳,溜,六
剑	舰,健,箭,荐,溅,见,件,贱,渐,键,监,践,间,建,涧,鉴	碱,肩,俭,茧,歼,艰,煎,奸,拣,减,剪,检,简,坚,兼,捡,尖,柬
刽	筷,会,快,块	
厉	利,立,粒,隶,丽,砾,力,痢,莉,例,俐,雳,吏,历,励,沥,荔,栗	哩,李,里,理,厘,璃,离,漓,篱,梨,犁,礼,狸,鲤,黎
唠	牢,劳	姥,烙,络,老,捞,酪
嘹	辽,燎,聊,疗,缭,撩,僚,寥,潦	了,料
嘲	招,着,朝,昭,巢,潮,召	沼,罩,钞,炒,找,抄,爪,吵,赵,超,剿,照,兆
嘿	黑	
嘴		罪,堆,醉,最
哗	滑,划,猾,桦,华,豁,花	画,话,化
喷		盆
嘶	私,撕,思,司,丝,斯	伺,肆,四,赐,食,饲,死,寺,似
啸	酵,校,孝,效,肖,笑	哮,小,销,萧,嚣,削,硝,宵,箫,学,消,晓
叽	期,唧,激,饥,几,绩,箕,居,肌,讥,其,稽,奇,机,畸,积,鸡,迹,基	吉,吃,技,即,圾,集,祭,冀,嫉,籍,借,脊,际,级,寂,寄,系,剂,继,忌,击,极,季,记,济,纪,妓,辑,计,疾,既,及,己,急,给,鲫,骑,挤,棘,荠
增	曾,憎	赠
坟	焚	份,吩,忿,芬,粪,奋,粉,纷,愤,分,氛
坠	赘,缀	追,锥,椎
堕	惰,灰,踱,跺,恢,舵,辉,徽,驮,度,挥	躲,蛔,回,慧,悔,讳,贿,溃,绘,多,晦,夺,茴,诲,汇,惠,朵,毁,会,秽,虫
墩	蹲,敦	盾,顿,吨,钝,囤,盹
嬉	西,悉,希,晰,溪,厘,析,稀,栖,牺,膝,熙,犀,吸,蟋,行,携,畦	席,息,习,昔,锡,喜,惜,细,夕,隙,系,徙,熄,媳,袭,洗,戏
娇	蕉,教,焦,椒,骄,交,郊,礁,浇,胶	窖,搅,缴,叫,觉,轿,狡,矫,嚼,角,侥,校,脚,剿,较,饺,绞
宽		款
审	沈,婶	肾,绅,深,神,信,呻,身,渗,伸,参,申,甚,慎
写	血	泻,楔,解,骇,谐,卸,谢,些,携,协,斜,械,蟹,胁,屑,歇,邪,屉,懈,鞋,挟,契
层	曾	
履	缕,旅,铝,侣,吕,娄,屡	虑,滤,率,绿,氯,驴,律
幢	床,撞	囱,抢,窗,闯,创,疮
帜	质,知,挚,识,秩,制,志,窒,智,治,置,滞,稚,致,至	植,汁,蜘,织,吱,旨,直,值,芝,枝,职,殖,只,之,趾,指,止,纸,脂,氏,执,支,肢,掷,址,征
废	肺,费,沸,吠	飞,匪,啡,菲,诽,肥,非
厨	橱,锄,雏,储,除	处,触,初,础,楚,畜,出,矗
庙	妙	瞄,渺,秒,苗,藐,描
广		逛,光
厂	敞,场	畅,唱,尝,长,裳,猖,肠,常,偿,倡,昌
弹	谈,石,淡,昙,蛋,旦,痰,坛,谭,但,潭,担,诞,檀,氮	丹,叹,坦,瘫,单,袒,贪,滩,炭,耽,摊,探,胆,碳,毯
影	景,颖	萤,赢,鹰,莺,婴,应,蝇,樱,硬,迎,荧,营,英,缨,鹦,盈,映,莹
德	得	的
庆	亲	顷,青,晴,蜻,卿,氢,清,轻,情,倾,请,擎
慧	惠,绘,讳,晦,诲,会,汇,秽,贿,溃	悔,灰,恢,毁,辉,茴,徽,回,蛔,挥,虫,堕
虑	滤,率,绿,氯,律	缕,旅,铝,侣,吕,驴,娄,履,屡
慕	沐,牧,幕,募,睦,穆,暮,目,墓,木	姥,拇,牡,模,母,姆,亩
忧	优,悠,幽	佑,又,由,犹,油,幼,右,游,诱,邮,尤,有,友
慰	胃,魏,尉,味,未,卫,位,喂,为,遗,谓,蔚,伪,畏	危,薇,萎,威,唯,苇,违,委,偎,围,微,伟,桅,巍,维,纬,尾
怜	联,廉,莲,连,帘,镰	炼,敛,练,恋,脸,链
悯	皿,敏,闽	民
憎	曾,增	赠
愤	份,忿,奋,粪,分	吩,坟,芬,纷,粉,焚,氛
憔	乔,瞧,侨,翘,桥	峭,窍,壳,鹊,撬,雀,敲,巧,锹,悄,俏,跷
摩	蘑,磨,摹,魔,模,膜	墨,末,寞,默,沫,么,莫,摸,没,抹,漠,茉,脉,陌
挚	质,知,识,秩,制,帜,志,窒,智,滞,置,治,稚,致,至	植,汁,蜘,织,吱,旨,直,值,芝,枝,职,殖,只,之,趾,指,止,纸,脂,氏,执,支,肢,掷,址,征
摹	蘑,磨,魔,摩,模,膜	墨,末,寞,默,沫,么,莫,摸,没,抹,漠,茉,脉,陌
撞	状,床,幢,壮	妆,囱,桩,抢,窗,装,庄,闯,创,疮
捞		姥,烙,络,牢,老,唠,劳,酪
撑	称	澄,呈,橙,逞,惩,承,成,程,秤,乘,城,盛,诚
撰	传,转,赚	专,砖
拨	播,剥,玻,般,菠	跛,舶,驳,膊,白,簸,搏,脖,泊,渤,荸,卜,博,柏,勃,伯,薄
挠		闹,恼,脑
撕	私,思,司,丝,斯,嘶	伺,肆,四,赐,食,饲,死,寺,似
撩	辽,燎,聊,疗,缭,僚,嘹,寥,潦	了,料
撒	洒	萨,飒
撮	搓,锉,措,挫,错	
播	薄,簸,拨,剥,玻,般,菠	跛,舶,驳,膊,白,搏,脖,泊,渤,荸,卜,博,柏,勃,伯
抚	甫,父,斧,脯,府,俯,辅,腐	辐,符,麸,负,咐,复,副,缚,腹,服,扶,妇,夫,孵,肤,赋,福,俘,附,浮,蝠,付,幅,赴,芙,袱,拂,敷,富,傅,伏
撬	峭,窍,壳,敲,锹,翘,俏,跷	乔,瞧,鹊,雀,巧,侨,悄,桥,憔
敌	涤,嘀,嫡,的,笛,芽	低,缔,抵,第,蒂,帝,地,滴,递,底,弟
敷	肤,夫,麸,孵	甫,辐,符,负,咐,复,缚,腹,辅,扶,妇,服,父,赋,福,俘,附,浮,蝠,付,抚,幅,斧,赴,腐,伏,芙,袱,拂,脯,府,俯,富,傅,副
数	鼠,率,蜀,勺,树,述,蟀,烁,暑,束,恕,黍,疏,薯,竖,曙,属,墅,术,硕,庶,漱,帅,署	枢,抒,熟,梳,书,叔,淑,舒,蔬,赎,殊,输,说
暮	沐,牧,幕,募,慕,睦,穆,目,墓,木	姥,拇,牡,模,母,姆,亩
暂	占,站,战,颤,蘸,栈,赞,绽	毡,斩,咱,盏,崭,展,瞻,沾
暴	瀑,爆,豹,铺,抱,报,刨	胞,圃,包,仆,保,苞,朴,葡,扑,浦,菩,薄,普,褒,宝,谱,堡,蒲,雹,脯,饱
样	养,漾	央,杨,阳,氧,扬,鸯,羊,仰,殃,秧,痒,洋
樟	彰,章,张	胀,丈,掌,长,杖,涨,障,帐,仗,账
桩	妆,装,庄	状,撞,壮
枢	抒,梳,书,舒,蔬,殊,输,疏	鼠,蜀,树,赎,述,暑,束,恕,黍,薯,竖,曙,淑,属,墅,术,庶,漱,数,熟,叔,署
标	彪,膘	表
槽	曹	草,糙,操
模	蘑,磨,摹,魔,摩,膜	墨,沐,默,母,姆,陌,牧,末,莫,么,沫,穆,抹,募,茉,摸,牡,暮,目,漠,墓,脉,亩,幕,寞,姥,慕,拇,没,睦,木
楼	娄	漏,搂,篓,陋,露
樊	矾,凡,烦,繁,帆	犯,泛,饭,番,贩,翻,范,反,返
桨	奖,讲,蒋	将,酱,浆,强,降,匠,僵,疆,姜,江,缰
乐	肋,越,悦,钥,跃,月,拗,勒,耀,粤,阅,岳,药,垃,要,说	遥,约,邀,咬,谣,么,窑,哟,舀,淆,吆,姚,妖,夭,肴,腰,了,摇,侥
欧	呕,殴,区,鸥	藕,偶
毅	掖,衣,忆,溢,肄,易,屹,一,亿,意,艺,邑,义,绎,议,亦,译,益,逸,翼,奕,液,役,谊,艾,腋,抑,疫,异	已,乙,疑,倚,医,揖,夷,移,矣,遗,宜,尾,椅,蛇,漪,姨,壹,以,依,胰,仪,伊,蚁
殴	呕,区,欧,鸥	藕,偶
浆	将,僵,疆,缰,姜,江	奖,强,桨,酱,蒋,降,匠,讲
澄	呈,橙,惩,承,成,程,乘,城,盛,诚	撑,逞,秤,称
泼	坡,波	迫,魄,破,颇,泊,婆,朴,剖
潦	辽,燎,聊,疗,缭,撩,僚,嘹,寥	了,料
洁	结,劫,捷,截,竭,杰,节	借,界,街,诫,揭,皆,阶,解,介,芥,接,姊,届,戒,姐
浇	蕉,教,焦,椒,骄,交,郊,礁,胶,娇	窖,搅,缴,叫,觉,轿,狡,矫,嚼,角,侥,校,脚,剿,较,饺,绞
潭	谈,昙,坛,痰,谭,弹,檀	叹,碳,坦,瘫,袒,贪,滩,摊,探,炭,毯
潜	钱,钳,黔,干,前	浅,铅,千,遣,谴,嵌,迁,纤,牵,谦,签,歉,欠
潮	巢,嘲,朝	钞,炒,抄,吵,超,剿
澎	蓬,彭,烹,棚,砰,硼,朋,篷,膨,鹏	捧,碰
溃	慧,惠,绘,愧,讳,晦,诲,会,汇,秽,贿	窥,亏,堕,悔,盔,灰,恢,虫,毁,葵,魁,辉,徽,茴,蛔,挥,傀,回
润	闰	
涧	舰,健,箭,荐,剑,溅,见,件,贱,渐,键,监,践,间,建,鉴	碱,肩,俭,茧,歼,艰,煎,奸,拣,减,剪,检,简,坚,兼,捡,尖,柬
潘	攀	盘,判,盼,叛,胖,般,畔
熟	叔,赎,淑	鼠,蜀,手,树,述,寿,梳,暑,首,束,守,恕,蔬,受,输,疏,黍,兽,薯,抒,竖,书,曙,属,收,墅,授,术,庶,枢,漱,数,署,舒,售,瘦,殊
熬		傲,澳,拗,懊,奥,凹,袄
热		若,惹
奖	讲,桨,蒋	将,酱,浆,强,降,匠,僵,疆,姜,江,缰
莹	萤,赢,迎,蝇,荧,营,盈	影,莺,鹰,婴,应,硬,英,缨,景,鹦,樱,映,颖
璃	丽,厘,离,漓,篱,梨,犁,狸,黎	立,砾,痢,俐,鲤,沥,哩,隶,励,粒,李,里,厉,雳,历,荔,栗,利,力,理,莉,例,吏,礼
瘩	达,搭,答	大,打
瘟	温	紊,纹,问,文,蚊,免,闻,吻,稳
瘤	留,刘,流,榴,琉,硫,泵	馏,陆,铆,柳,溜,六
瘦	寿,售,授,受,兽	熟,手,首,守,收
疮	囱,窗,创	撞,抢,床,闯,幢
皱	咒,昼,宙	轴,洲,州,周,舟,帚,肘,粥
盘	般,胖	潘,判,盼,叛,攀,畔
瞎	虾	下,夏,侠,辖,暇,斜,狭,吓,匣,挟,峡,厦,霞,洽
磅	傍,蚌,棒,谤,乓,旁	膀,螃,梆,邦,帮,庞,胖,榜,绑
确	壳,鹊,雀,却,怯	瘸,缺
碾	撵,捻	念,年
磕	刻,颗,棵,科,苛,蝌	坷,壳,克,可,咳,课,客,渴
码	玛,马,蚂,吗	么,麻,妈,骂,蟆
稿	搅,搞	高,糕,告,篙,膏,羔
稼	价,假,驾,架,嫁,贾	夏,夹,佳,茄,甲,挟,钾,嘉,加,荚,家,颊
稽	几,箕,启,起,其,鸡,居,肌,机,叽,讥,期,唧,激,饥,乞,绩,积,基,奇,岂,畸,迹	吉,吃,技,即,气,圾,崎,柒,集,鳍,祭,冀,嫉,枝,戚,籍,借,弃,脊,溪,际,旗,级,寂,寄,脐,只,剂,系,迄,继,忌,器,泣,击,欺,极,祈,季,漆,记,砌,纪,妓,栖,济,企,辑,歧,齐,计,七,疾,既,及,己,急,凄,妻,棋,给,鲫,骑,挤,契,畦,汽,棘,荠
稻	蹈,导,到,盗,悼,倒,道	祷,岛,叨,捣,刀
窑	遥,谣,淆,姚,肴,摇,侥	邀,乐,咬,么,哟,舀,吆,钥,拗,耀,妖,夭,腰,药,要
穷	琼	
箭	舰,健,荐,剑,溅,见,件,贱,渐,键,监,践,间,建,涧,鉴	碱,肩,俭,茧,歼,艰,煎,奸,拣,减,剪,检,简,坚,兼,捡,尖,柬
箱	镶,乡,厢,相,香,湘	响,向,享,祥,想,详,像,降,橡,巷,项,象,翔
篇	扁,翩,偏	骗,遍,片,便
糊	壶,胡,蝴,葫,湖,狐,弧	护,许,乎,唬,沪,虎,互,戏,呼,户,忽
缔	蒂,的,第,帝,地,递,弟	涤,嘀,嫡,低,滴,抵,笛,芽,底,敌
练	恋,链,敛,炼	怜,脸,联,廉,莲,连,帘,镰
纬	萎,苇,委,伟,尾	威,谓,巍,魏,味,未,围,喂,遗,畏,胃,薇,位,为,微,伪,桅,维,偎,慰,尉,唯,卫,违,蔚,危
缅	冕,免,勉,娩	棉,绵,面,眠
编	蝙,边,鞭	贬,变,便,匾,辩,辫,辨,扁,遍
缘	援,源,辕,猿,员,园,袁,圆,原,元	宛,远,怨,愿,院,冤,渊,鸳
线	腺,宪,现,限,馅,县,陷,献	贤,险,先,闲,涎,掀,嫌,铣,鲜,衔,弦,纤,舷,显,癣,仙,咸
缎	断,锻,段	端,短
缓		焕,痪,欢,幻,环,涣,还,唤,宦,患,换
骂		码,么,麻,蚂,妈,玛,马,吗,蟆
罢	爸,疲,坝,耙,脾,啤,皮,霸,伯,吧	芭,否,靶,叭,被,匹,把,屁,披,坏,捌,笆,巴,批,八,疤,辟,跋,霹,扒,譬,僻,劈,拔
翩	扁,偏,篇	骗,遍,片,便
膛	塘,搪,堂,糖,唐,棠	烫,淌,汤,趟,倘,躺
膜	墨,末,寞,默,莫,蘑,沫,磨,茉,摹,没,魔,摩,模,漠,脉,陌	么,抹,摸
膝	西,悉,希,晰,溪,厘,析,稀,栖,牺,嬉,熙,犀,吸,蟋,行,携,畦	席,息,习,昔,锡,喜,惜,细,夕,隙,系,徙,熄,媳,袭,洗,戏
胶	蕉,教,焦,椒,骄,交,郊,礁,浇,娇	窖,搅,缴,叫,觉,轿,狡,矫,嚼,角,侥,校,脚,剿,较,饺,绞
肤	夫,麸,孵,敷	甫,辐,符,负,咐,复,缚,腹,辅,扶,妇,服,父,赋,福,俘,附,浮,蝠,付,抚,幅,斧,赴,腐,伏,芙,袱,拂,脯,府,俯,富,傅,副
膘	标,彪	表
蔗	宅,这,浙	着,遮,摘,哲,折,者,辙
蔽	闭,币,毙,碧,毕,泌,避,璧,比,壁,弊,臂,辟,庇,鄙,必	笔,彼,逼,匕,鼻
蔚	慰,胃,魏,尉,味,未,卫,位,喂,为,遗,谓,伪,畏	危,薇,萎,威,唯,苇,违,委,偎,围,微,伟,桅,巍,维,纬,尾
莲	怜,联,廉,连,帘,镰	炼,敛,练,恋,脸,链
蔬	枢,抒,梳,书,舒,殊,输,疏	鼠,蜀,树,赎,述,暑,束,恕,黍,薯,竖,曙,淑,属,墅,术,庶,漱,数,熟,叔,署
蔓	慢,曼,漫,幔	满,瞒,蛮,馒
蔑	灭	
蒋	奖,讲,桨	将,酱,浆,强,降,匠,僵,疆,姜,江,缰
蓬	澎,彭,棚,硼,朋,篷,膨,鹏	捧,碰,烹,砰
葱	从,囱,聪,匆	丛
蝴	糊,壶,胡,葫,湖,狐,弧	护,许,乎,唬,沪,虎,互,戏,呼,户,忽
蝶	跌,谍,叠,碟	爹
蝠	袱,幅,拂,福,辐,俘,符,浮,扶,缚,服,夫,伏,芙	甫,复,麸,负,咐,腹,妇,辅,孵,父,肤,赋,附,付,抚,斧,赴,腐,脯,府,俯,敷,富,傅,副
虾	瞎	下,夏,侠,辖,暇,斜,狭,吓,匣,挟,峡,厦,霞,洽
蜗	瓜,刮,括	褂,挂,卦,寡
蝙	边,鞭,编	贬,变,便,匾,辩,辫,辨,扁,遍
蝗	惶,皇,凰,黄,煌	恍,谎,幌,慌,晃,荒
蝌	刻,颗,棵,科,磕,苛	坷,壳,克,可,咳,课,客,渴
卫	慰,胃,魏,尉,味,未,位,喂,为,遗,谓,蔚,伪,畏	危,薇,萎,威,唯,苇,违,委,偎,围,微,伟,桅,巍,维,纬,尾
褐	盒,何,禾,核,荷,合,盖,和,河	喝,呵,吓,赫,贺,鹤
褒	胞,苞,包	暴,保,爆,刨,宝,雹,豹,饱,堡,抱,报,薄
谊	掖,衣,忆,溢,易,肄,疑,屹,一,亿,意,艺,议,邑,义,绎,毅,夷,移,遗,亦,译,宜,益,蛇,逸,翼,奕,姨,液,役,胰,艾,仪,腋,抑,疫,异	椅,依,已,乙,医,揖,尾,伊,蚁,漪,矣,倚,壹,以
谅	晾,凉,亮,量,辆	粮,良,粱,俩,两,梁
谈	昙,潭,坛,痰,谭,弹,檀	叹,碳,坦,瘫,袒,贪,滩,摊,探,炭,毯
谆	屯	准
诞	石,淡,蛋,但,旦,担,弹,氮	丹,耽,胆,单
请	顷,情	青,晴,蜻,亲,卿,氢,庆,轻,情,倾,清,擎
诸	蛛,珠,朱,株,猪	柱,轴,蛀,逐,注,住,煮,驻,主,竹,属,烛,嘱,拄,铸,术,助,祝,贮,筑
课	克,可,刻,客	坷,颗,壳,棵,科,磕,咳,苛,渴,蝌
调	条,吊,钓,掉	刁,挑,叼,碉,跳,雕
谁		水,税,蜕,说,睡
论	轮,沦,抡,仑,伦	
诽	菲,匪	费,沸,飞,肺,废,啡,肥,吠,非
豌	弯,湾	宛,挽,婉,碗,丸,惋,完,顽,万,腕,晚,玩,娩
竖	述,漱,数,曙,束,恕,署,树,墅,术,庶,疏	鼠,薯,抒,枢,熟,蜀,梳,暑,书,叔,淑,属,舒,蔬,赎,殊,输,黍
猪	蛛,诸,朱,株,珠	柱,轴,蛀,逐,注,住,煮,驻,主,竹,属,烛,嘱,拄,铸,术,助,祝,贮,筑
赔	陪,培	坏,配,胚,佩,沛
赏	上,晌	商,裳,伤,汤,尚
赋	父,复,附,咐,负,副,富,赴,妇,傅,腹,付	甫,辐,符,麸,缚,服,扶,辅,夫,孵,肤,福,俘,浮,蝠,抚,幅,斧,腐,芙,袱,拂,脯,府,俯,敷,伏
贱	舰,健,箭,荐,剑,溅,见,件,渐,键,监,践,间,建,涧,鉴	碱,肩,俭,茧,歼,艰,煎,奸,拣,减,剪,检,简,坚,兼,捡,尖,柬
账	胀,丈,长,杖,涨,障,帐,仗	樟,掌,张,彰,章
赌	睹,肚,堵	妒,牍,读,渡,毒,督,都,度,镀,杜,独
贤	涎,闲,嫌,衔,弦,舷,咸	腺,宪,馅,先,掀,现,铣,鲜,纤,癣,限,显,县,陷,仙,献,险,线
卖	迈,脉,麦	埋,买
赐	伺,刺,肆,四,次,厕,食,饲,寺,似	私,撕,词,此,雌,磁,思,辞,差,慈,死,司,丝,斯,祠,瓷,嘶
质	植,知,直,值,置,治,滞,至,职,秩,殖,帜,智,致,识,挚,窒,稚,执,掷,制,志	吱,指,蜘,织,汁,氏,止,支,肢,旨,址,只,之,征,脂,趾,芝,枝,纸
趟	烫	膛,塘,搪,淌,汤,倘,躺,堂,糖,唐,棠
趣	促,趋,漆,醋,错,娶,簇,去,卒	圈,岖,蛆,取,渠,驱,区,曲,躯,粗,屈
践	舰,健,箭,荐,剑,溅,见,件,贱,渐,键,监,涧,间,建,鉴	碱,肩,俭,茧,歼,艰,煎,奸,拣,减,剪,检,简,坚,兼,捡,尖,柬
踢	剔,梯	剃,堤,屉,提,体,啼,题,涕,替,蹄,惕
踏	塌,蹋	塔
踩	彩,睬,采	材,裁,猜,财,菜,才
躺	倘,淌	烫,塘,膛,搪,汤,趟,堂,糖,唐,棠
辉	灰,恢,徽,挥,堕	慧,绘,惠,悔,贿,讳,汇,毁,晦,茴,诲,会,溃,蛔,秽,虫,回
辆	晾,凉,亮,量,谅	粮,良,粱,俩,两,梁
辈	备,贝,狈,背,惫,焙,臂,倍,被	北,杯,卑,碑,悲
轮	论,沦,抡,仑,伦	
适	恃,誓,侍,饰,嗜,士,式,拭,事,示,室,释,识,市,使,世,势,是,氏,视,柿,逝,试	拾,石,提,失,射,始,虱,十,屎,尸,矢,什,驶,匙,实,史,食,师,硕,湿,蚀,狮,诗,时,施
遮	着	这,宅,浙,摘,哲,折,者,辙,蔗
遭	糟	躁,蚤,凿,造,枣,噪,早,灶,藻,燥,澡,皂
迁	铅,千,嵌,纤,牵,谦,签	浅,钱,遣,谴,钳,黔,歉,欠,干,潜,前
邻	淋,磷,琳,鳞,林,临	凛,赁,吝,躏
郑	正,政,症,挣,证	怔,拯,狰,睁,争,丁,整,症,征,筝,蒸
邓	瞪,凳,蹬	等,灯,登
醇	唇,纯,淳	蠢,春
醉	罪,最	嘴,堆
醋	趋,促,错,趣,簇,卒	粗
锌	芯,薪,新,心,辛,欣	衅,信,寻
销	哮,萧,嚣,削,硝,宵,箫,消	小,啸,酵,校,学,肖,效,孝,笑,晓
铺	暴,瀑,仆,扑	普,圃,朴,脯,谱,仆,葡,浦,菩,蒲
铐	靠	考,拷,烤
锄	厨,橱,雏,储,除	处,触,初,础,楚,畜,出,矗
铝	缕,旅,侣,吕,屡,履,娄	虑,滤,率,绿,氯,驴,律
锐	瑞	蕊
锉	挫,撮,错,措	搓
锋	疯,峰,风,蜂,讽,封,丰,枫	冯,奉,凤,逢,缝
阅	乐,越,悦,钥,跃,月,耀,粤,岳,药,说	约
震	阵,枕,镇,振	疹,侦,诊,真,珍,贞,榛,斟,针
霉	眉,梅,媒,楣,没,枚,煤,玫	媚,每,美,昧,妹
靠	铐	考,拷,烤
鞍	氨,庵,安	按,岸,俺,暗,案
鞋	谐,协,邪,斜,胁,挟,携	泻,卸,懈,屉,械,蟹,谢,楔,些,屑,写,血,契,骇,歇,解
巩	矿,共,拱,汞	蚣,贡,宫,功,红,攻,弓,恭,工,躬,供,公
养	氧,样,漾,仰,痒	央,杨,阳,扬,羊,鸯,殃,秧,洋
饿	噩,哑,遏,俄,恶,愕,鳄,扼	讹,鹅,额,蛾,阿
馁	哪	内
驼	鸵,驮	拖,托,唾,脱,椭,妥,拓
驻	柱,蛀,注,住,铸,助,祝	轴,逐,猪,煮,蛛,主,竹,诸,属,烛,嘱,朱,拄,株,术,珠,贮,筑
驶	屎,使,矢,始,史	拾,石,恃,失,提,射,誓,侍,适,虱,饰,嗜,士,十,式,拭,事,示,室,尸,释,识,市,什,世,匙,势,实,硕,食,师,是,湿,氏,视,蚀,狮,诗,柿,逝,时,施,试
驾	稼,价,假,架,嫁,贾	夏,夹,佳,茄,甲,挟,钾,嘉,加,荚,家,颊
驹	俱,蛆,沮,居,车,锯,拘	拒,足,惧,菊,炬,剧,据,聚,橘,局,句,鞠,举,巨,具,距,矩
闹		恼,脑,挠
魄	迫,泊,朴,破	坡,颇,婆,波,剖,泼
鲁	卤,虏	路,卢,鹿,碌,炉,氯,芦,陆,庐,颅,露,赂,录
鸦	押,压,呀,鸭	哑,衙,雅,讶,轧,涯,蚜,牙,芽,亚
麸	肤,夫,孵,敷	甫,辐,符,负,咐,复,缚,腹,辅,扶,妇,服,父,赋,福,俘,附,浮,蝠,付,抚,幅,斧,赴,腐,伏,芙,袱,拂,脯,府,俯,富,傅,副
黎	丽,璃,厘,离,漓,篱,梨,犁,狸	立,砾,痢,俐,鲤,沥,哩,隶,励,粒,李,里,厉,雳,历,荔,栗,利,力,理,莉,例,吏,礼
墨	末,寞,默,莫,沫,磨,膜,没,漠,茉,脉,陌	么,蘑,摸,摹,魔,抹,摩,模
齿	尺,侈,耻	吃,池,嗤,持,翅,迟,驰,斥,匙,赤,弛
儒	如,蠕	乳,辱,褥,入,女
冀	技,季,际,记,济,妓,纪,寄,系,鲫,剂,骑,继,忌,祭,计,既,荠	吉,吃,即,几,圾,箕,其,稽,集,嫉,鸡,籍,借,脊,级,居,寂,肌,机,叽,击,讥,极,期,唧,激,饥,绩,辑,积,疾,基,及,己,急,奇,挤,畸,棘,迹,给
凝	狞,柠,宁,拧	泞
剂	计,技,季,际,记,济,妓,纪,寄,系,鲫,骑,继,忌,祭,冀,既,荠	吉,吃,即,几,圾,箕,其,稽,集,嫉,鸡,籍,借,脊,级,居,寂,肌,机,叽,击,讥,极,期,唧,激,饥,绩,辑,积,疾,基,及,己,急,奇,挤,畸,棘,迹,给
噩	哑,遏,俄,恶,饿,愕,鳄,扼	讹,鹅,额,蛾,阿
吨	盾,顿,钝,囤,盹	墩,蹲,敦
噪	躁,造,灶,燥,皂	糟,凿,蚤,枣,早,藻,澡,遭
器	弃,气,妻,砌,迄,汽,契,泣,企	启,起,鳍,稽,柒,其,崎,枝,戚,溪,旗,脐,只,欺,祈,期,漆,乞,栖,歧,七,凄,棋,骑,奇,畦,岂,齐
壁	闭,币,毙,蔽,碧,毕,泌,避,璧,比,弊,臂,辟,庇,鄙,必	笔,彼,逼,匕,鼻
垦	肯,啃,恳	
坛	谈,昙,潭,痰,谭,弹,檀	叹,碳,坦,瘫,袒,贪,滩,摊,探,炭,毯
奋	份,忿,粪,分,愤	吩,坟,芬,纷,粉,焚,氛
学	穴	小,薛,啸,箫,消,笑,雪,酵,校,效,肖,晓,哮,销,靴,萧,嚣,宵,硝,血,削,孝
导	祷,蹈,到,岛,盗,捣,悼,倒,道,稻	叨,刀
宪	腺,现,限,馅,县,陷,献,线	贤,险,先,闲,涎,掀,嫌,铣,鲜,衔,弦,纤,舷,显,癣,仙,咸
凭	屏,冯,坪,苹,平,评,萍,瓶	乒
惫	辈,备,贝,狈,背,焙,臂,倍,被	北,杯,卑,碑,悲
忆	掖,衣,溢,肄,易,屹,一,亿,意,艺,邑,义,绎,议,毅,亦,译,益,逸,翼,奕,液,役,谊,艾,腋,抑,疫,异	已,乙,疑,倚,医,揖,夷,移,矣,遗,宜,尾,椅,蛇,漪,姨,壹,以,依,胰,仪,伊,蚁
憾	悍,焊,汉,翰,旱,撼,汗,捍	韩,喊,罕,函,酣,含,寒,和,涵
懊	澳,傲,拗,奥	袄,凹,熬
懈	泻,卸,屉,蟹,谢,械,楔,屑,契,骇,解	谐,协,邪,斜,些,鞋,血,胁,写,挟,携,歇
战	占,站,颤,暂,蘸,栈,绽	毡,斩,盏,展,崭,瞻,沾
擅	善,赡,扇,膳,单	删,山,衫,珊,闪,杉,陕
拥	庸,咏,踊,蛹,泳,勇,永,佣	用,佣
挡	党,当,档,荡	铛,裆,当
撼	悍,焊,汉,翰,憾,旱,汗,捍	韩,喊,罕,函,酣,含,寒,和,涵
据	拒,足,惧,炬,俱,聚,锯,句,巨,具,距,剧	菊,蛆,沮,居,橘,车,鞠,矩,举,局,驹,拘
择	贼,则,泽,窄,责	怎,侧
擂	泪,类,累,雷	勒,垒,蕾,儡
操	糙	草,凑,槽,曹
捡	碱,茧,拣,减,剪,检,简,俭,柬	箭,见,建,歼,艰,煎,件,贱,键,践,鉴,舰,肩,渐,监,间,坚,尖,健,荐,剑,奸,涧,溅,兼
擒	禽,勤,秦,芹,琴	亲,寝,侵,钦
担	丹,石,淡,旦,蛋,但,诞,耽,弹,氮,单	胆
整	拯	怔,正,狰,睁,争,丁,政,郑,证,征,症,筝,挣,蒸
历	利,立,粒,隶,丽,砾,力,痢,莉,厉,例,俐,雳,吏,励,沥,荔,栗	哩,李,里,理,璃,厘,离,漓,梨,篱,犁,礼,狸,鲤,黎
晓	小	哮,销,萧,嚣,啸,削,硝,酵,宵,校,肖,箫,学,消,效,孝,笑
昙	谈,潭,坛,痰,谭,弹,檀	叹,碳,坦,瘫,袒,贪,滩,摊,探,炭,毯
桦	滑,话,化,划,猾,华,豁,画,哗	花
橙	澄,呈,惩,承,成,程,乘,城,盛,诚	撑,逞,秤,称
横	恒,衡	哼
橘	菊,局,鞠	拒,足,聚,举,剧,炬,沮,居,锯,句,巨,具,拘,惧,矩,蛆,俱,据,车,驹,距
树	述,竖,漱,数,束,曙,恕,署,墅,术,庶,疏	鼠,薯,抒,枢,熟,蜀,梳,暑,书,叔,淑,属,舒,蔬,赎,殊,输,黍
橄	敢,赶,感,秆,杆	柑,杆,竿,甘,肝,干
椭	妥	拖,托,唾,鸵,脱,拓,驮,驼
橡	向,乡,像,相,巷,项,象	响,镶,享,箱,祥,想,详,厢,降,香,湘,翔
桥	乔,瞧,侨,翘,憔	峭,窍,壳,鹊,撬,雀,敲,巧,锹,悄,俏,跷
机	期,唧,激,饥,几,绩,箕,居,肌,讥,其,稽,奇,畸,积,鸡,迹,叽,基	吉,吃,技,即,圾,集,祭,冀,嫉,籍,借,脊,际,级,寂,寄,系,剂,继,忌,击,极,季,记,济,纪,妓,辑,计,疾,既,及,己,急,给,鲫,骑,挤,棘,荠
淀	惦,佃,殿,电,店,垫,奠,玷,甸	颠,碘,典,点
澡	藻,蚤,早,枣	糟,躁,凿,造,噪,灶,燥,遭,皂
浓	农,脓	弄
泽	贼,则,择,窄,责	怎,侧
浊	茁,啄,酌,琢,着,卓,灼,拙	桌,捉
澳	懊,傲,拗,奥	袄,凹,熬
激	期,唧,饥,几,绩,箕,居,肌,讥,其,稽,奇,机,畸,积,鸡,迹,叽,基	吉,吃,技,即,圾,集,祭,冀,嫉,籍,借,脊,际,级,寂,寄,系,剂,继,忌,击,极,季,记,济,纪,妓,辑,计,疾,既,及,己,急,给,鲫,骑,挤,棘,荠
烧	稍,捎,梢	芍,勺,哨,少,绍,召
灯	登	瞪,蹬,邓,等,凳
燕	唁,烟,咽,焰,奄,殷,艳,研,沿,谚,厌,雁,砚,淹,验,堰,宴	延,癌,掩,阎,严,衍,眼,演,颜,盐,炎,言
燎	辽,聊,疗,缭,撩,僚,嘹,了,料,潦,寥	
烫	趟	膛,塘,搪,淌,汤,倘,躺,堂,糖,唐,棠
燃	然	染
独	牍,读,毒	睹,妒,肚,渡,督,都,赌,度,镀,杜,堵
瓢		飘,漂,票
瘸		确,壳,鹊,雀,缺,却,怯
卢	颅,庐,炉,芦	路,鲁,鹿,碌,氯,陆,卤,露,赂,录,虏
瞒	馒,漫,蛮	满,曼,蔓,幔,慢
磨	墨,末,寞,默,莫,蘑,沫,茉,膜,摹,没,魔,摩,模,漠,脉,陌	么,抹,摸
砖	专	传,撰,转,赚
积	期,唧,激,饥,几,绩,箕,居,肌,讥,其,稽,奇,机,畸,叽,鸡,迹,基	吉,吃,技,即,圾,集,祭,冀,嫉,籍,借,脊,际,级,寂,寄,系,剂,继,忌,击,极,季,记,济,纪,妓,辑,计,疾,既,及,己,急,给,鲫,骑,挤,棘,荠
颖	景,影	萤,赢,鹰,莺,婴,应,蝇,樱,硬,迎,荧,营,英,缨,鹦,盈,映,莹
穆	沐,牧,幕,募,慕,睦,暮,目,墓,木	姥,拇,牡,模,母,姆,亩
窥	亏,盔	愧,葵,魁,傀,溃
篙	高,糕,膏,羔	搅,搞,告,稿
篡	窜	
筛		晒,杀
糕	高,篙,膏,羔	搅,搞,告,稿
糖	塘,膛,搪,堂,唐,棠	烫,淌,汤,趟,倘,躺
缚	袱,幅,拂,福,辐,俘,符,服,浮,蝠,扶,夫,伏,芙	甫,复,麸,负,咐,腹,妇,辅,孵,父,肤,赋,附,付,抚,斧,赴,腐,脯,府,俯,敷,富,傅,副
县	腺,宪,悬,现,漩,玄,限,旋,馅,陷,献,线	先,闲,嫌,选,咸,铣,弦,轩,显,癣,险,衔,宣,贤,涎,掀,炫,纤,舷,喧,仙,鲜
翰	悍,焊,汉,憾,旱,撼,汗,捍	韩,喊,罕,函,酣,含,寒,和,涵
膳	善,赡,扇,擅,单	删,山,衫,珊,闪,杉,陕
腻	逆,匿,泥,溺	你,呢,拟,尼
膨	澎,蓬,彭,棚,硼,朋,篷,鹏	捧,碰,烹,砰
兴	幸,猩,星,腥,杏,性,姓	刑,醒,邢,形,行,型
艘	骚,搔	嫂,扫
舱	仓,苍,沧	藏
蕊		瑞,锐
荡	当,挡	裆,铛,党,当,档
蕉	教,焦,椒,骄,交,郊,礁,浇,胶,娇	窖,搅,缴,叫,觉,轿,狡,矫,嚼,角,侥,校,脚,剿,较,饺,绞
萧	哮,销,嚣,削,硝,宵,箫,消	小,啸,酵,校,学,肖,效,孝,笑,晓
芜	无,梧,巫,亡,蜈,吴,诬	屋,武,于,物,误,污,侮,勿,呜,舞,五,乌,坞,务,雾,晤,鹉,午,捂,恶,悟,伍
螃	膀,庞,旁	胖,磅,乓
螟	明,鸣,名,铭	命
蚂	码,马,吗,玛	么,麻,妈,骂,蟆
萤	赢,迎,蝇,荧,营,盈,莹	影,莺,鹰,婴,应,硬,英,缨,景,鹦,樱,映,颖
融	蓉,绒,熔,容,茸,榕,溶,荣	冗
衡	横,恒	哼
褪		吞,囤,臀,屯
裤	酷,库	窟,枯,哭,苦
褥	入,辱	儒,乳,如,蠕,女
亲	庆,侵,钦	顷,禽,青,晴,勤,蜻,卿,秦,轻,清,芹,氢,倾,情,擒,寝,琴,请,擎
谚	燕,验,咽,焰,艳,研,沿,厌,雁,砚,宴,堰,唁,淹	延,癌,掩,阎,严,衍,烟,眼,奄,殷,演,颜,盐,炎,言
讳	慧,惠,绘,晦,诲,会,汇,秽,贿,溃	悔,灰,恢,毁,辉,茴,徽,回,蛔,挥,虫,堕
谋		某
谍	蝶,跌,碟,叠	爹
谐	协,邪,斜,鞋,胁,挟,携	泻,卸,懈,屉,械,蟹,谢,楔,些,屑,写,血,契,骇,歇,解
诺	懦,糯	娜,挪
谒	叶,夜,咽,射,页,业	爷,冶,野,也,椰
谓	慰,胃,魏,尉,味,未,卫,位,喂,为,遗,蔚,伪,畏	危,薇,萎,威,唯,苇,违,委,偎,围,微,伟,桅,巍,维,纬,尾
讽	疯,奉,峰,风,蜂,丰,封,凤,枫,锋,缝	冯,逢
豫	狱,预,语,欲,玉,御,愈,吁,喻,寓,誉,郁,浴,域,裕,育,尉,谷,芋,与,遇	隅,羽,雨,屿,宇,愉,于,迂,鱼,愚,予,榆,逾,淤,渔,娱,舆
猫		冒,矛,毛,茂,锚,贸,帽,茅,貌
赖	癞	莱,来
蹄	堤,提,题,啼	剃,屉,体,梯,踢,剔,涕,替,惕
踱	惰,跺,舵,度,驮,堕	夺,朵,躲,多
踊	咏,蛹,泳,勇,永,拥	庸,用,佣
蹂	柔,揉	肉
辐	袱,幅,拂,福,服,俘,符,浮,蝠,缚,扶,夫,伏,芙	甫,复,麸,负,咐,腹,妇,辅,孵,父,肤,赋,附,付,抚,斧,赴,腐,脯,府,俯,敷,富,傅,副
辑	吉,极,借,及,吃,脊,唧,即,急,圾,级,寂,集,嫉,击,疾,棘,籍	技,几,箕,其,稽,祭,冀,鸡,际,居,肌,寄,系,剂,继,机,忌,叽,讥,期,季,激,饥,记,济,绩,纪,妓,荠,计,积,既,基,己,鲫,骑,奇,挤,畸,迹,给
输	枢,抒,梳,书,舒,蔬,殊,疏	鼠,蜀,树,赎,述,暑,束,恕,黍,薯,竖,曙,淑,属,墅,术,庶,漱,数,熟,叔,署
辨	变,便,辩,辫,遍	蝙,贬,边,编,鞭,扁,匾
办	伴,拌,半,瓣,绊,扮	版,班,板,扳,颁,搬,般,斑
遵	尊	俊
选		悬,炫,还,漩,玄,轩,喧,县,旋,宣
迟	池,持,驰,匙,弛	吃,嗤,齿,侈,翅,斥,耻,赤,尺
辽	燎,聊,疗,缭,撩,僚,嘹,寥,了,潦	了,料
遗	谓,疑,一,魏,味,未,夷,移,喂,宜,畏,蛇,胃,位,为,伪,姨,谊,胰,慰,尉,仪,卫,蔚	掖,已,乙,衣,威,忆,委,溢,易,肄,倚,屹,巍,亿,意,艺,议,邑,义,医,绎,揖,毅,围,矣,亦,译,益,伟,椅,尾,薇,逸,翼,漪,奕,微,维,液,桅,役,偎,以,依,纬,壹,艾,萎,唯,苇,违,伊,蚁,抑,疫,异,腋,危
醒	省	兴,幸,型,刑,星,猩,邢,形,腥,杏,行,性,姓
锭	钉,定,订	盯,丁,鼎,叮,顶
锯	拒,足,惧,驹,蛆,俱,炬,据,沮,居,聚,车,句,巨,具,距,剧,拘	菊,橘,鞠,举,局,矩
锰	猛	孟,蒙,盟,朦,梦,檬,萌
错	措,锉,促,醋,趋,挫,趣,撮,簇,卒	粗,搓
钱	钳,黔,干,潜,前	浅,铅,千,遣,谴,嵌,迁,纤,牵,谦,签,歉,欠
钢	肛,岗,刚,纲,冈,扛,缸	港
锡	席,息,习,昔,惜,媳,袭,熄	希,吸,行,溪,稀,隙,牺,系,膝,熙,犀,携,戏,洗,西,悉,晰,喜,栖,嬉,蟋,厘,析,细,夕,徙,畦
录	路,鹿,碌,氯,陆,露,赂	卢,炉,芦,庐,卤,颅,鲁,虏
锥	追,椎	坠,赘,缀
锦	谨,仅,尽,紧	津,巾,近,晋,尽,襟,劲,进,金,筋,禁,今,浸,斤
阎	延,癌,严,研,沿,颜,盐,炎,言	燕,掩,眼,衍,验,烟,咽,焰,奄,艳,殷,演,厌,谚,雁,砚,淹,堰,唁,宴
隧	穗,碎,遂,祟,岁	髓,随,虽
随		虽,髓,穗,碎,遂,祟,隧,岁
险	铣,癣,鲜,显	宪,先,闲,嫌,现,限,陷,咸,线,弦,馅,腺,衔,县,献,贤,涎,掀,纤,舷,仙
雕	叼,碉,刁	吊,调,钓,掉
霎	厦,煞	沙,杀,傻,砂,纱,杉
霍	豁,惑,祸,货,获,或	活,火,和,伙
静	径,境,竞,劲,净,靖,敬,镜,竟	精,京,兢,晶,鲸,警,颈,更,阱,景,睛,荆,惊,经,井,茎
颊	荚,夹,挟	夏,稼,价,佳,假,驾,茄,架,甲,嘉,钾,嫁,加,家,贾
颈	警,景,井,阱	兢,静,晶,鲸,靖,惊,竟,精,境,更,睛,茎,径,京,劲,敬,荆,竞,净,镜,经
频	濒,贫	品,拼,聘
头	投	偷,透
颓		蜕,腿,推,退
餐	参	蚕,残,惨,灿,惭
馆	管	冠,观,罐,关,棺,灌,贯,官,惯
馅	腺,宪,现,限,县,陷,献,线	贤,险,先,闲,涎,掀,嫌,铣,鲜,衔,弦,纤,舷,显,癣,仙,咸
骇	泻,害,卸,懈,屉,蟹,谢,械,楔,亥,屑,契,解	谐,协,海,邪,斜,还,些,鞋,血,胁,写,咳,挟,携,歇,孩
骆	烙,络,酪,落,洛	罗,螺,萝,骡,箩,逻,裸,锣
鸵	驮,驼	拖,托,唾,脱,椭,妥,拓
鸯	秧,央,殃	养,阳,氧,扬,样,羊,漾,仰,洋,杨,痒
鸭	鸦,押,压,呀	哑,衙,雅,讶,轧,涯,蚜,牙,芽,亚
鸳	宛,冤,渊	援,远,怨,缘,愿,源,辕,猿,院,员,园,袁,圆,原,元
默	墨,末,寞,莫,沫,磨,膜,没,漠,茉,脉,陌	么,蘑,摸,摹,魔,抹,摩,模
黔	钱,钳,干,潜,前	浅,铅,千,遣,谴,嵌,迁,纤,牵,谦,签,歉,欠
龙	隆,咙,窿,聋,胧,笼	垄,拢
龟	丘,规,蚯,君,傀,钧,瑰,闺,均,归,秋,军	求,俊,诡,仇,窘,囚,峻,竣,柜,球,骏,贵,轨,桂,菌,鬼,跪
优	悠,忧,幽	佑,又,由,犹,油,幼,右,游,诱,邮,尤,有,友
偿	尝,裳,长,肠,场,常	畅,唱,猖,厂,敞,倡,昌
儡	累,蕾,垒	擂,勒,泪,类,雷
储	处,厨,橱,锄,础,雏,楚,除	触,初,畜,出,矗
励	利,立,粒,隶,丽,砾,力,痢,莉,厉,例,俐,雳,吏,历,沥,荔,栗	哩,李,里,理,厘,璃,离,漓,篱,梨,犁,礼,狸,鲤,黎
嚎	壕,豪,号,毫,鹤	镐,耗,浩,好,蒿
吓	下,夏,喝,暇,荷,赫,厦,和,贺,鹤	侠,盒,辖,呵,虾,斜,狭,何,禾,核,匣,合,挟,褐,峡,盖,洽,瞎,霞,河
壕	嚎,豪,号,毫,鹤	镐,耗,浩,好,蒿
压	鸦,押,呀,鸭	哑,衙,雅,讶,轧,涯,蚜,牙,芽,亚
婴	莺,鹰,应,英,缨,鹦,樱	萤,赢,影,硬,迎,蝇,荧,营,景,盈,映,莹,颖
屿	羽,宇,雨,语,予,与	狱,隅,预,于,欲,鱼,玉,御,吁,舆,愈,豫,喻,寓,渔,誉,郁,浴,域,裕,迂,愚,淤,育,尉,愉,谷,芋,榆,逾,娱,遇
岭	领	铃,玲,凌,龄,零,菱,陵,翎,另,令,蛉,伶,灵
帮	梆,傍,邦	膀,蚌,磅,榜,棒,旁,绑,谤
弥	谜,靡,糜,迷	蜜,咪,泌,密,觅,秘,米
徽	灰,恢,辉,挥,堕	慧,绘,惠,悔,贿,讳,汇,毁,晦,茴,诲,会,溃,蛔,秽,虫,回
应	因,莺,鹰,婴,硬,英,缨,鹦,樱,映	萤,赢,影,迎,蝇,荧,营,景,盈,莹,颖
懂	董	东,冻,动,洞,栋,冬
恳	肯,垦,啃	
懦	诺,糯	娜,挪
戏	乎,夕,隙,系,细,呼,忽	息,希,习,吸,行,许,糊,席,溪,锡,稀,护,牺,葫,膝,熙,犀,携,媳,熄,洗,西,悉,晰,喜,惜,栖,嬉,湖,互,狐,弧,蟋,壶,胡,厘,析,昔,蝴,唬,徙,沪,虎,畦,袭,户
戴	带,逮,待,大,代,怠,贷,袋	呆,歹
擎	晴,倾,情	顷,青,蜻,亲,卿,氢,庆,轻,清,请
击	吉,极,借,及,吃,脊,唧,即,急,圾,级,寂,集,辑,嫉,疾,棘,籍	技,几,箕,其,稽,祭,冀,鸡,际,居,肌,寄,系,剂,继,机,忌,叽,讥,期,季,激,饥,记,济,绩,纪,妓,荠,计,积,既,基,己,鲫,骑,奇,挤,畸,迹,给
挤	己,脊,几,济,给	吉,吃,技,即,圾,箕,其,稽,集,祭,冀,嫉,鸡,籍,借,际,级,居,寂,寄,肌,系,剂,继,机,忌,叽,击,讥,极,期,季,唧,激,饥,记,绩,纪,妓,辑,计,积,疾,既,基,及,急,鲫,骑,奇,畸,棘,迹,荠
拧	狞,柠,凝,宁	泞
拟	你	呢,匿,泥,腻,尼,溺,逆
搁	戈,胳,鸽,疙,割,哥,歌	个,格,葛,阁,合,各,隔,革,蛤
敛	恋,练,链,炼	怜,脸,联,廉,莲,连,帘,镰
毙	闭,币,蔽,碧,毕,泌,避,璧,比,壁,弊,臂,辟,庇,鄙,必	笔,彼,逼,匕,鼻
曙	述,竖,漱,数,束,恕,署,树,墅,术,庶,疏	鼠,薯,抒,枢,熟,蜀,梳,暑,书,叔,淑,属,舒,蔬,赎,殊,输,黍
檀	谈,昙,潭,坛,痰,谭,弹	叹,碳,坦,瘫,袒,贪,滩,摊,探,炭,毯
档	党,挡	铛,裆,当,荡
检	碱,茧,拣,减,剪,简,俭,捡,柬	箭,见,建,歼,艰,煎,件,贱,键,践,鉴,舰,肩,渐,监,间,坚,尖,健,荐,剑,奸,涧,溅,兼
毡	瞻,占,沾	站,战,斩,盏,颤,暂,崭,展,蘸,栈,绽
泞		拧,宁,柠,凝,狞,能
滨	濒,缤,宾,彬	鬓
济	技,几,祭,冀,脊,际,寄,系,剂,继,忌,季,记,妓,纪,荠,计,既,己,鲫,骑,挤,给	吉,吃,即,圾,箕,其,稽,集,嫉,鸡,籍,借,级,居,寂,肌,机,叽,击,讥,极,期,唧,激,饥,绩,辑,积,疾,基,及,急,奇,畸,棘,迹
涛	逃,桃,掏,滔,陶,萄,淘	讨,套
滥	烂,缆	篮,懒,览,榄,澜,拦,兰,蓝,揽,栏
涩	圾,瑟,塞,色	
湿	失,尸,狮,诗,虱,师,施	拾,石,恃,提,射,誓,侍,适,始,饰,嗜,士,十,式,拭,屎,事,示,室,释,识,市,使,矢,什,世,驶,匙,势,实,史,食,硕,是,氏,视,蚀,柿,逝,时,试
营	萤,赢,迎,蝇,荧,盈,莹	影,莺,鹰,婴,应,硬,英,缨,景,鹦,樱,映,颖
灿		蚕,残,餐,惨,参,惭
燥	躁,造,噪,灶,皂	糟,凿,蚤,枣,早,藻,澡,遭
烛	轴,逐,竹,术,筑	柱,蛀,注,住,煮,蛛,驻,主,珠,诸,属,嘱,拄,朱,铸,株,助,猪,祝,贮
爵	诀,倔,觉,掘,嚼,角,绝,脚,决	
墙	强	将,呛,抢,枪,腔
狞	柠,凝,宁,拧	泞
获	霍,豁,惑,祸,货,或	火,伙,和,活
环	还	焕,痪,缓,欢,幻,涣,唤,宦,患,换
疗	辽,燎,聊,缭,撩,僚,嘹,寥,潦	了,料
癌	延,阎,严,研,沿,颜,盐,炎,言	燕,掩,眼,衍,验,烟,咽,焰,奄,艳,殷,演,厌,谚,雁,砚,淹,堰,唁,宴
瞳	桐,彤,童,同,铜	筒,通,统,痛,桶
瞪	凳,邓,蹬	等,灯,登
瞬	顺	吮,盾
瞧	乔,侨,翘,桥,憔	峭,窍,壳,鹊,撬,雀,敲,巧,锹,悄,俏,跷
矫	搅,缴,狡,角,绞,脚,剿,较,饺,侥	窖,蕉,教,焦,叫,觉,椒,骄,嚼,交,校,郊,礁,浇,轿,胶,娇
磷	淋,邻,琳,鳞,林,临	凛,赁,吝,躏
礁	蕉,教,焦,椒,骄,交,郊,浇,胶,娇	窖,搅,缴,叫,觉,轿,狡,矫,嚼,角,侥,校,脚,剿,较,饺,绞
穗	碎,遂,祟,隧,岁	髓,随,虽
窿	隆,龙,咙,胧,聋,笼	垄,拢
簇	趋,促,醋,错,趣,卒	粗
篓	搂	漏,楼,陋,露,娄
篷	澎,蓬,彭,棚,硼,朋,膨,鹏	捧,碰,烹,砰
糠	慷,康	炕,抗,扛
糜	弥,谜,靡,迷	蜜,咪,泌,密,觅,秘,米
粪	份,忿,奋,分,愤	吩,坟,芬,纷,粉,焚,氛
糟	遭	躁,蚤,凿,造,枣,噪,早,灶,藻,燥,澡,皂
糙	操	草,凑,槽,曹
缩	梭,唆,肃,速,宿,素,嗦,诉,溯,塑,粟	酥,琐,俗,所,锁,苏,索
绩	期,唧,激,饥,几,居,箕,肌,讥,其,稽,奇,机,畸,积,鸡,迹,叽,基	吉,吃,技,即,圾,集,祭,冀,嫉,籍,借,脊,际,级,寂,寄,系,剂,继,忌,击,极,季,记,济,纪,妓,辑,计,疾,既,及,己,急,给,鲫,骑,挤,棘,荠
缕	旅,铝,侣,吕,娄,履,屡	虑,滤,率,绿,氯,驴,律
绷	崩	蹦
缝	冯,奉,讽,凤,逢	疯,峰,风,蜂,封,丰,枫,锋
总		从,棕,宗,踪,综,纵
纵	从,棕,宗,踪,综	总
繁	矾,凡,烦,樊,帆	犯,泛,饭,番,贩,翻,范,反,返
纤	先,铅,千,掀,嵌,迁,牵,谦,签,歉,欠,仙,鲜	宪,闲,嫌,现,限,陷,咸,线,钱,铣,弦,馅,显,癣,险,腺,谴,钳,衔,黔,县,干,献,潜,贤,浅,涎,遣,舷,前
翼	掖,衣,忆,溢,肄,易,屹,一,亿,意,艺,邑,义,绎,议,毅,亦,译,益,逸,奕,液,役,谊,艾,腋,抑,疫,异	已,乙,疑,倚,医,揖,夷,移,矣,遗,宜,尾,椅,蛇,漪,姨,壹,以,依,胰,仪,伊,蚁
声	生,胜,升,甥,牲,笙	绳,剩,乘,圣,省,盛
聪	从,囱,匆,葱	丛
联	怜,廉,莲,连,帘,镰	炼,敛,练,恋,脸,链
耸		松,诵,送,讼,颂,宋
臂	备,被,币,贝,毙,蔽,比,毕,壁,庇,辈,闭,避,背,璧,辟,鄙,狈,碧,泌,惫,弊,焙,倍,必	杯,笔,北,卑,彼,逼,碑,匕,鼻,悲
臀	囤,屯	吞,褪
脓	农,浓	弄
胆		丹,石,淡,旦,蛋,但,诞,担,耽,弹,氮,单
脸		炼,敛,怜,镰,练,恋,联,廉,莲,连,帘,链
临	淋,磷,邻,琳,鳞,林	凛,赁,吝,躏
举	沮,矩	拒,足,聚,剧,炬,居,锯,句,巨,具,拘,惧,菊,蛆,俱,据,橘,车,鞠,驹,局,距
艰	肩,歼,煎,奸,渐,监,间,溅,坚,兼,尖	箭,见,拣,减,剪,建,捡,件,贱,键,践,鉴,俭,碱,舰,茧,检,简,柬,健,荐,剑,涧
薪	芯,新,心,辛,锌,欣	衅,信,寻
薄	舶,驳,膊,白,簸,搏,脖,播,泊,渤,雹,荸,卜,博,柏,勃,伯	胞,跛,爆,保,宝,褒,苞,拨,剥,玻,豹,般,饱,包,堡,抱,暴,报,菠,刨
蕾	垒,累,儡	擂,勒,泪,类,雷
薯	鼠,数,蜀,暑,属,署,黍	树,赎,述,梳,束,恕,蔬,输,疏,抒,竖,书,曙,淑,墅,术,庶,枢,漱,熟,叔,舒,殊
薛	靴	雪,穴,血,削,学
薇	唯,违,围,为,微,桅,巍,维,危	威,委,谓,魏,味,未,喂,遗,畏,伟,尾,胃,位,伪,偎,纬,慰,尉,萎,卫,苇,蔚
亏	盔,窥	愧,葵,魁,傀,溃
蟀	率,帅,数,烁,勺,硕	摔,甩,说,衰
蟆	么,麻,吗	码,蚂,妈,玛,骂,马
螺	罗,萝,箩,骡,逻,锣	洛,烙,络,裸,骆,落,酪
蟋	西,悉,希,晰,溪,厘,析,稀,栖,牺,嬉,膝,熙,犀,吸,携,行,畦	席,息,习,昔,锡,喜,惜,细,夕,隙,系,徙,熄,媳,袭,洗,戏
谜	弥,靡,糜,迷	蜜,咪,泌,密,觅,秘,米
谤	傍,蚌,磅,棒,旁	膀,梆,邦,帮,榜,绑
谦	铅,千,嵌,迁,纤,牵,签	浅,钱,遣,谴,钳,黔,歉,欠,干,潜,前
讲	奖,桨,蒋	将,酱,浆,强,降,匠,僵,疆,姜,江,缰
谎	幌,晃,恍	惶,皇,凰,黄,慌,蝗,煌,荒
谣	遥,窑,淆,姚,肴,摇,侥	邀,乐,咬,么,哟,舀,吆,钥,拗,耀,妖,夭,腰,药,要
谢	泻,卸,懈,屉,蟹,械,楔,屑,契,骇,解	谐,协,邪,斜,些,鞋,血,胁,写,挟,携,歇
誊	腾,疼	
豁	滑,划,霍,桦,华,猾,惑,祸,货,获,哗,或	话,化,活,伙,花,画,火,和,或
赚	传,撰,转,钻	专,砖
赛	塞	腮
购	够,构,垢	苟,沟,狗,句,勾,钩
趋	圈,岖,蛆,促,醋,错,趣,驱,区,簇,曲,卒,躯,屈	取,漆,渠,娶,去,粗
蹋	塌,踏	塔
蹈	导,到,盗,悼,倒,道,稻	祷,岛,叨,捣,刀
辖	侠,暇,斜,狭,匣,挟,峡,霞,洽	下,夏,虾,吓,厦,瞎
辕	援,缘,源,猿,员,园,袁,圆,原,元	宛,远,怨,愿,院,冤,渊,鸳
舆	隅,愉,于,榆,鱼,愚,予,逾,渔,娱	狱,雨,屿,预,语,欲,玉,御,吁,愈,豫,羽,喻,寓,誉,郁,浴,域,裕,迂,淤,育,宇,尉,谷,芋,与,遇
避	闭,币,毙,蔽,碧,毕,泌,比,璧,壁,弊,臂,辟,庇,鄙,必	笔,彼,逼,匕,鼻
还	悬,环,漩,玄,旋,孩	焕,害,痪,缓,欢,海,幻,炫,涣,换,唤,宦,亥,咳,轩,喧,骇,选,患,宣
迈	卖,脉,麦	埋,买
邀	么,哟,吆,妖,夭,腰,要	遥,乐,咬,谣,窑,舀,淆,钥,拗,姚,耀,肴,药,摇,侥
酝	蕴,运,韵,员,孕,晕	匀,云,陨,耘,允
镀	妒,肚,渡,度,杜	睹,牍,读,毒,督,都,赌,独,堵
锚	茅,矛,毛	冒,猫,茂,贸,帽,貌
键	舰,健,箭,荐,剑,溅,见,件,贱,渐,监,践,间,建,涧,鉴	碱,肩,俭,茧,歼,艰,煎,奸,拣,减,剪,检,简,坚,兼,捡,尖,柬
锅	郭	过,国,果,裹
锤	垂,捶,椎	吹,炊
锹	敲,跷,撬	峭,瞧,乔,窍,壳,鹊,桥,雀,巧,侨,翘,悄,俏,憔
锻	断,缎,段	端,短
阔	括,廓,扩	
隐	瘾,引,印,听,蚓,饮	因,姻,音,银,淫,吟,殷,茵,阴
隶	利,立,粒,力,丽,砾,痢,莉,厉,例,俐,雳,吏,历,励,沥,荔,栗	哩,李,里,理,厘,璃,离,漓,篱,梨,犁,礼,狸,鲤,黎
虽		随,髓,穗,碎,遂,祟,隧,岁
霜	双	爽
霞	侠,辖,暇,斜,狭,匣,挟,峡,洽	下,夏,虾,吓,厦,瞎
鞠	菊,局,橘	拒,足,聚,举,剧,炬,沮,居,锯,句,巨,具,拘,惧,矩,蛆,俱,据,车,驹,距
韩	函,含,汗,寒,涵	悍,喊,罕,焊,汉,翰,憾,酣,旱,撼,和,捍
颗	刻,棵,科,磕,苛,蝌	坷,壳,克,可,咳,课,客,渴
骏	俊,竣,峻,菌	君,钧,窘,龟,均,军
鲜	先,掀,铣,纤,显,癣,仙,险	贤,腺,宪,闲,涎,嫌,现,衔,弦,限,舷,馅,县,陷,献,咸,线
鸿	宏,洪,虹,红	轰,烘,哄,汞
鸽	搁,戈,胳,疙,割,哥,歌	个,格,葛,阁,合,各,隔,革,蛤
点	碘,典	颠,惦,佃,淀,殿,电,店,垫,奠,玷,甸
斋	齐,摘	寨,债,宅,窄,祭,责
丛	从	囱,聪,匆,葱
垒	累,蕾,儡	擂,勒,泪,类,雷
婶	沈,审	肾,绅,深,神,信,呻,身,渗,伸,参,申,甚,慎
戳		绰
扩	括,廓,阔	
掷	植,质,执,职,殖,直,值	吱,汁,蜘,织,知,旨,置,芝,滞,治,枝,至,秩,只,帜,之,智,趾,致,识,指,止,挚,窒,纸,脂,稚,氏,支,肢,制,址,志,征
扰		饶,绕
撵	捻,碾	念,年
摆	百	拜,败,白
断	缎,锻,段	端,短
朦	檬,蒙,萌,盟	孟,梦,锰,猛
檬	朦,蒙,萌,盟	孟,梦,锰,猛
柜	跪,贵,桂	规,鬼,诡,瑰,闺,龟,轨,归,傀
柠	狞,凝,宁,拧	泞
归	规,瑰,闺,龟,傀	鬼,柜,贵,桂,轨,跪,诡
泻	卸,懈,屉,蟹,谢,械,楔,屑,契,骇,解	谐,协,邪,斜,些,鞋,血,胁,写,挟,携,歇
滤	虑,率,绿,氯,律	缕,旅,铝,侣,吕,驴,娄,履,屡
溅	箭,见,建,歼,艰,煎,件,贱,键,践,鉴,舰,肩,渐,监,间,坚,尖,健,荐,剑,奸,涧,兼	碱,茧,拣,减,剪,检,简,俭,捡,柬
瀑	暴,铺	普,圃,朴,脯,谱,葡,仆,扑,浦,菩,蒲
猎	劣,烈,裂,列	咧
璧	闭,币,毙,蔽,碧,毕,泌,避,比,壁,弊,臂,辟,庇,鄙,必	笔,彼,逼,匕,鼻
瞻	占,毡,沾	站,战,斩,盏,颤,暂,崭,展,蘸,栈,绽
础	处,楚,储	厨,触,橱,初,锄,雏,畜,出,除,矗
礼	哩,李,里,理,鲤	立,砾,璃,痢,俐,狸,沥,隶,离,犁,励,粒,丽,厉,梨,雳,篱,历,荔,栗,利,力,厘,莉,漓,例,吏,黎
秽	慧,惠,绘,讳,晦,诲,会,汇,贿,溃	悔,灰,恢,毁,辉,茴,徽,回,蛔,挥,虫,堕
窜	篡	
窍	峭,壳,撬,翘,俏,跷	乔,瞧,鹊,雀,敲,巧,锹,侨,悄,桥,憔
箫	哮,销,萧,嚣,削,宵,硝,消	小,啸,酵,校,学,肖,效,孝,笑,晓
简	碱,茧,拣,减,剪,检,俭,捡,柬	箭,见,建,歼,艰,煎,件,贱,键,践,鉴,舰,肩,渐,监,间,坚,尖,健,荐,剑,奸,涧,溅,兼
粮	良,凉,粱,量,梁	晾,俩,两,亮,谅,辆
织	吱,汁,蜘,支,肢,知,只,之,脂,芝,枝,氏	植,旨,直,值,置,滞,治,至,职,秩,殖,帜,智,趾,致,识,指,质,止,挚,窒,纸,稚,执,掷,制,址,志,征
绕		饶,扰
缭	辽,燎,聊,疗,撩,僚,嘹,寥,潦	了,料
绣	臭,宿,秀,锈,嗅,袖	休,羞,修,朽
翘	峭,瞧,乔,窍,撬,壳,桥,侨,俏,跷,憔	鹊,雀,敲,巧,锹,悄
翻	番,帆	犯,矾,凡,泛,烦,樊,饭,繁,贩,范,反,返
职	植,质,执,掷,殖,直,值	吱,汁,蜘,织,知,旨,置,芝,滞,治,枝,至,秩,只,帜,之,智,趾,致,识,指,止,挚,窒,纸,脂,稚,氏,支,肢,制,址,志,征
聂	孽,镊	捏
脐	祈,期,旗,棋,只,崎,鳍,奇,其,骑,歧,畦,枝,齐	气,启,起,柒,稽,戚,弃,溪,迄,器,泣,欺,漆,砌,乞,栖,七,凄,妻,契,汽,岂,企
旧	救,疚,臼,舅,究,就	酒,韭,鸠,久,灸,九,揪,玖,纠
藏	脏,葬	脏,仓,沧,舱,赃,苍
萨	飒	撒,洒
蓝	篮,澜,拦,兰,栏	懒,烂,滥,览,榄,缆,揽
藐	渺,秒	瞄,苗,妙,描,庙
荠	计,技,季,际,记,济,妓,纪,寄,系,鲫,剂,骑,继,忌,祭,冀,既	吉,吃,即,几,圾,箕,其,稽,集,嫉,鸡,籍,借,脊,级,居,寂,肌,机,叽,击,讥,极,期,唧,激,饥,绩,辑,积,疾,基,及,己,急,奇,挤,畸,棘,迹,给
蝉	缠,馋,单	阐,搀,掺,产,铲
谨	仅,尽,紧,锦	津,巾,近,晋,尽,襟,劲,进,金,筋,禁,今,浸,斤
赘	坠,缀	追,锥,椎
蹦		崩,绷
踪	纵,综,棕,宗	从,总
转	传,撰,赚	专,砖
辙	摘,撤,澈,哲,折,彻	这,扯,着,浙,宅,遮,车,蔗,者
医	依,揖,衣,漪,伊,壹,一	掖,已,乙,忆,溢,易,肄,疑,倚,屹,亿,意,艺,议,邑,义,绎,毅,夷,移,矣,遗,亦,译,宜,益,尾,椅,蛇,逸,翼,奕,姨,液,役,以,谊,胰,艾,仪,蚁,抑,疫,异,腋
酱	匠,将,强,降	奖,桨,浆,蒋,僵,疆,姜,江,讲,缰
厘	希,璃,吸,狸,行,溪,稀,离,牺,膝,犁,熙,携,犀,西,悉,晰,丽,栖,梨,篱,嬉,蟋,析,漓,畦,黎	立,息,砾,习,痢,俐,鲤,沥,哩,隶,席,锡,隙,系,媳,戏,励,熄,洗,粒,李,里,喜,惜,厉,雳,历,荔,栗,利,力,理,昔,莉,细,夕,例,徙,吏,礼,袭
锁	所,琐,索	嗦,缩,唆,梭
镇	阵,枕,震,振	疹,侦,诊,真,珍,贞,榛,斟,针
镐	耗,浩,好,号	嚎,壕,豪,毫,鹤,蒿
闯	抢,创	囱,撞,窗,床,幢,疮
离	丽,璃,厘,漓,篱,梨,犁,狸,黎	立,砾,痢,俐,鲤,沥,哩,隶,励,粒,李,里,厉,雳,历,荔,栗,利,力,理,莉,例,吏,礼
杂	砸,咱	
双	霜	爽
雏	厨,橱,锄,储,除	处,触,初,础,楚,畜,出,矗
鸡	期,唧,激,饥,几,绩,箕,居,肌,讥,其,稽,奇,机,畸,积,迹,叽,基	吉,吃,技,即,圾,集,祭,冀,嫉,籍,借,脊,际,级,寂,寄,系,剂,继,忌,击,极,季,记,济,纪,妓,辑,计,疾,既,及,己,急,给,鲫,骑,挤,棘,荠
鞭	蝙,边,编	贬,变,便,匾,辩,辫,辨,扁,遍
额	鹅,俄,蛾,讹	噩,哑,阿,遏,恶,饿,愕,鳄,扼
颜	延,癌,阎,严,研,沿,盐,炎,言	燕,掩,眼,衍,验,烟,咽,焰,奄,艳,殷,演,厌,谚,雁,砚,淹,堰,唁,宴
题	堤,提,蹄,啼	剃,屉,体,梯,踢,剔,涕,替,惕
馏	溜,陆,六	留,瘤,刘,流,榴,铆,琉,柳,硫,泵
骑	技,崎,鳍,其,祭,冀,枝,际,旗,寄,脐,只,剂,系,继,忌,祈,期,季,记,济,纪,妓,歧,荠,计,既,棋,鲫,奇,畦,齐	吉,吃,气,即,几,圾,箕,启,起,柒,稽,集,嫉,鸡,戚,籍,借,弃,脊,溪,级,居,寂,肌,迄,机,器,泣,叽,击,欺,讥,极,唧,激,饥,漆,砌,绩,栖,乞,辑,积,七,疾,基,及,己,急,凄,妻,给,挤,契,汽,岂,畸,棘,迹,企
魏	慰,胃,尉,味,未,卫,位,喂,为,遗,谓,蔚,伪,畏	危,薇,萎,威,唯,苇,违,委,偎,围,微,伟,桅,巍,维,纬,尾
鲤	哩,李,里,理,礼	立,砾,璃,痢,俐,狸,沥,隶,离,犁,励,粒,丽,厉,梨,雳,篱,历,荔,栗,利,力,厘,莉,漓,例,吏,黎
鲫	计,技,季,际,记,济,妓,纪,寄,系,剂,骑,继,忌,祭,冀,既,荠	吉,吃,即,几,圾,箕,其,稽,集,嫉,鸡,籍,借,脊,级,居,寂,肌,机,叽,击,讥,极,期,唧,激,饥,绩,辑,积,疾,基,及,己,急,奇,挤,畸,棘,迹,给
鹃	圈,捐,身	绢,倦,卷,眷
鹅	额,蛾,俄,讹	噩,哑,阿,遏,恶,饿,愕,鳄,扼
垄	拢	隆,龙,咙,窿,胧,聋,笼
宠		崇,充,重,冲,虫
庞	膀,螃,旁	胖,磅,乓
庐	炉,卢,颅,芦	路,鲁,鹿,碌,氯,陆,卤,露,赂,录,虏
惩	澄,呈,橙,承,成,程,乘,城,盛,诚	撑,逞,秤,称
怀	徊,槐,淮	坏
懒	榄,揽,览,缆	篮,烂,滥,澜,拦,兰,蓝,栏
攀	潘	盘,判,盼,叛,胖,般,畔
拢	垄	隆,龙,咙,窿,胧,聋,笼
旷	框,矿,况,眶	筐,狂
橱	厨,锄,雏,储,除	处,触,初,础,楚,畜,出,矗
沥	利,立,粒,隶,丽,砾,力,痢,莉,厉,例,俐,雳,吏,历,励,荔,栗	哩,李,里,理,厘,璃,离,漓,篱,梨,犁,礼,狸,鲤,黎
濒	宾,滨,彬,缤,贫,频	品,拼,鬓,聘
爆	豹,抱,暴,报,刨	胞,保,褒,雹,苞,宝,饱,包,堡,薄
烁	率,帅,数,蟀,勺,硕	说
牍	读,毒,独	睹,妒,肚,渡,督,都,赌,度,镀,杜,堵
兽	寿,瘦,售,授,受	熟,手,首,守,收
琼	穷	
瓣	伴,办,拌,半,绊,扮	版,班,板,扳,颁,搬,般,斑
畴	稠,酬,愁,筹,绸,仇	丑,臭,抽
疆	将,浆,僵,缰,姜,江	奖,强,桨,酱,蒋,降,匠,讲
瘪		鳖,别
碍	爱,隘,艾	挨,矮,哎,哀,埃,唉,蔼
祷	倒,导,捣,岛	蹈,到,叨,盗,刀,悼,道,稻
稳	吻	紊,纹,问,瘟,文,蚊,免,闻,温
簿	埠,怖,部,步,不,布	补,捕,卜,哺
簸	跛,播,薄	舶,驳,膊,白,搏,脖,泊,渤,拨,剥,荸,玻,般,卜,博,柏,勃,伯,菠
签	铅,千,嵌,迁,纤,牵,谦	浅,钱,遣,谴,钳,黔,歉,欠,干,潜,前
茧	碱,拣,减,剪,检,简,俭,捡,柬	箭,见,建,歼,艰,煎,件,贱,键,践,鉴,舰,肩,渐,监,间,坚,尖,健,荐,剑,奸,涧,溅,兼
绎	掖,衣,忆,溢,肄,易,屹,一,亿,意,艺,邑,义,议,毅,亦,译,益,逸,翼,奕,液,役,谊,艾,腋,抑,疫,异	已,乙,疑,倚,医,揖,夷,移,矣,遗,宜,尾,椅,蛇,漪,姨,壹,以,依,胰,仪,伊,蚁
绳		盛,生,胜,乘,升,声,甥,牲,剩,圣,省,笙
绘	慧,惠,讳,晦,诲,会,汇,秽,贿,溃	悔,灰,恢,毁,辉,茴,徽,回,蛔,挥,虫,堕
罗	萝,螺,箩,骡,逻,锣	洛,烙,络,裸,骆,落,酪
缴	搅,狡,矫,侥,角,脚,剿,较,饺,绞	窖,蕉,教,焦,叫,觉,椒,骄,嚼,交,校,郊,礁,浇,轿,胶,娇
羹	更,耕	梗,耿,埂
腊	辣,落,蜡	喇,拉,啦
艺	掖,衣,忆,溢,肄,易,屹,一,亿,意,议,邑,义,绎,毅,亦,译,益,逸,翼,奕,液,役,谊,艾,腋,抑,疫,异	已,乙,疑,倚,医,揖,夷,移,矣,遗,宜,尾,椅,蛇,漪,姨,壹,以,依,胰,仪,伊,蚁
藕	呕,偶	鸥,殴,欧,区
药	乐,越,悦,钥,跃,月,拗,耀,粤,阅,岳,要,说	遥,约,邀,咬,谣,么,窑,哟,舀,淆,吆,姚,妖,夭,肴,腰,摇,侥
蚁	椅,已,乙,矣,倚,以,尾	掖,衣,忆,溢,易,肄,疑,屹,一,亿,意,艺,议,邑,义,医,绎,揖,毅,夷,移,遗,亦,译,宜,益,蛇,逸,翼,漪,奕,姨,液,役,壹,依,谊,胰,艾,仪,伊,抑,疫,异,腋
蝇	萤,赢,迎,荧,营,盈,莹	影,莺,鹰,婴,应,硬,英,缨,景,鹦,樱,映,颖
蟹	泻,卸,懈,屉,谢,械,楔,屑,契,骇,解	谐,协,邪,斜,些,鞋,血,胁,写,挟,携,歇
裆	铛,当	党,档,挡,荡
襟	津,巾,筋,金,禁,今,浸,斤	近,仅,尽,晋,劲,锦,进,谨,紧
袄		傲,熬,澳,拗,懊,奥,凹
谱	圃,普,浦	瀑,朴,葡,脯,仆,铺,扑,暴,菩,蒲
识	知,恃,适,誓,侍,饰,嗜,士,置,滞,治,式,至,拭,事,示,秩,室,帜,释,智,致,市,质,使,挚,窒,世,势,是,稚,氏,视,制,志,柿,逝,试	植,吱,拾,织,蜘,汁,石,提,失,旨,射,始,直,虱,值,芝,枝,十,屎,职,殖,只,尸,之,趾,指,止,矢,什,驶,匙,实,史,食,脂,硕,纸,师,湿,执,支,肢,掷,址,蚀,狮,诗,时,施,征
证	正,政,郑,症,挣	怔,拯,狰,睁,争,丁,整,症,征,筝,蒸
谭	谈,昙,潭,坛,痰,弹,檀	叹,碳,坦,瘫,袒,贪,滩,摊,探,炭,毯
讥	期,唧,激,饥,几,绩,箕,居,肌,其,稽,奇,机,畸,积,鸡,迹,叽,基	吉,吃,技,即,圾,集,祭,冀,嫉,籍,借,脊,际,级,寂,寄,系,剂,继,忌,击,极,季,记,济,纪,妓,辑,计,疾,既,及,己,急,给,鲫,骑,挤,棘,荠
赠		曾,憎,增
赞	暂	咱
蹲	墩,敦	盾,顿,吨,钝,囤,盹
蹬	凳,邓,瞪	等,灯,登
跷	峭,窍,撬,壳,敲,锹,翘,俏	乔,瞧,鹊,雀,巧,侨,悄,桥,憔
轿	窖,教,叫,觉,校,较	焦,角,交,脚,剿,娇,蕉,狡,胶,侥,椒,骄,嚼,郊,饺,绞,搅,缴,矫,礁,浇
辞	词,雌,磁,慈,祠,瓷	此,伺,刺,次,差,赐,厕
边	蝙,鞭,编	贬,变,便,匾,辩,辫,辨,扁,遍
镜	径,境,竞,静,劲,净,靖,敬,竟	精,京,兢,晶,鲸,警,颈,更,阱,景,睛,荆,惊,经,井,茎
铲	产,阐	缠,搀,馋,掺,单,蝉
链	练,恋,敛,炼	怜,脸,联,廉,莲,连,帘,镰
关	冠,观,棺,官	罐,馆,灌,管,贯,惯
难	男,南	
雾	晤,误,坞,勿,务,恶,悟,物	屋,武,于,芜,污,侮,呜,无,舞,五,吴,乌,梧,蜈,鹉,午,巫,亡,捂,诬,伍
靡	谜,弥,糜,迷,米	蜜,咪,泌,密,觅,秘
韵	蕴,运,员,酝,孕,晕	匀,云,陨,耘,允
类	擂,累,泪	垒,勒,雷,蕾,儡
颠		惦,佃,淀,典,点,殿,电,店,垫,奠,碘,玷,甸
馒	漫,蛮,瞒	满,曼,蔓,幔,慢
骗	遍,片	便,偏,篇,扁,翩
鲸	精,京,兢,晶,更,睛,荆,惊,经,茎	径,境,竞,静,劲,净,警,靖,颈,阱,景,敬,镜,井,竟
鹉	侮,武,舞,午,五,捂,伍	屋,于,诬,芜,物,误,污,勿,呜,无,吴,乌,坞,梧,务,蜈,雾,晤,巫,亡,恶,悟
鹊	确,壳,雀,巧,却,怯,悄	峭,瞧,乔,窍,撬,桥,敲,锹,瘸,侨,翘,俏,跷,憔,缺
鹏	澎,蓬,彭,棚,硼,朋,篷,膨	捧,碰,烹,砰
丽	立,砾,璃,痢,俐,狸,沥,隶,离,犁,励,粒,厉,梨,雳,篱,历,荔,栗,利,力,厘,莉,漓,例,吏,黎	哩,李,里,理,礼,鲤
劝	券	圈,卷,全,权,拳,痊,泉,犬
咙	隆,龙,窿,胧,聋,笼	垄,拢
嚷	攘,壤	让,瓤
严	延,癌,阎,研,沿,颜,盐,炎,言	燕,掩,眼,衍,验,烟,咽,焰,奄,艳,殷,演,厌,谚,雁,砚,淹,堰,唁,宴
嚼	诀,倔,觉,掘,角,绝,脚,决,爵	窖,焦,交,剿,较,娇,蕉,校,狡,胶,侥,叫,椒,骄,郊,轿,饺,绞,搅,教,缴,矫,礁,浇
壤	攘,嚷	让,瓤
孽	镊,聂	捏
宝	饱,保,堡	胞,薄,暴,爆,苞,雹,褒,豹,包,抱,报,刨
悬	还,漩,玄,县,旋	炫,轩,喧,选,宣
攘	瓤,嚷,壤	让
拦	篮,澜,兰,蓝,栏	懒,烂,滥,览,榄,缆,揽
搀	掺	阐,缠,馋,产,铲,单,蝉
胧	隆,龙,咙,窿,聋,笼	垄,拢
澜	篮,拦,兰,蓝,栏	懒,烂,滥,览,榄,缆,揽
炉	庐,卢,颅,芦	路,鲁,鹿,碌,氯,陆,卤,露,赂,录,虏
献	腺,宪,现,限,馅,县,陷,线	贤,险,先,闲,涎,掀,嫌,铣,鲜,衔,弦,纤,舷,显,癣,仙,咸
痒	养,仰,氧	央,杨,阳,扬,样,鸯,羊,漾,殃,秧,洋
矿	共,巩,汞,况,眶,旷,框,拱	蚣,贡,宫,功,狂,筐,红,攻,弓,恭,工,躬,供,公
矾	凡,烦,樊,繁,帆	犯,泛,饭,番,贩,翻,范,反,返
砾	利,立,粒,隶,丽,力,痢,莉,厉,例,俐,雳,吏,历,励,沥,荔,栗	哩,李,里,理,厘,璃,离,漓,篱,梨,犁,礼,狸,鲤,黎
竞	径,境,静,劲,净,靖,敬,镜,竟	精,京,兢,晶,鲸,警,颈,更,阱,景,睛,荆,惊,经,井,茎
筹	稠,酬,愁,畴,绸,仇	丑,臭,抽
篮	澜,拦,兰,蓝,栏	懒,烂,滥,览,榄,缆,揽
籍	吉,极,借,及,吃,脊,唧,即,急,圾,级,寂,集,辑,嫉,击,疾,棘	技,几,箕,其,稽,祭,冀,鸡,际,居,肌,寄,系,剂,继,机,忌,叽,讥,期,季,激,饥,记,济,绩,纪,妓,荠,计,积,既,基,己,鲫,骑,奇,挤,畸,迹,给
糯	懦,诺	娜,挪
辫	变,便,辩,辨,遍	蝙,贬,边,编,鞭,扁,匾
缤	濒,宾,滨,彬	鬓
继	计,技,季,际,记,济,妓,纪,寄,系,鲫,剂,骑,忌,祭,冀,既,荠	吉,吃,即,几,圾,箕,其,稽,集,嫉,鸡,籍,借,脊,级,居,寂,肌,机,叽,击,讥,极,期,唧,激,饥,绩,辑,积,疾,基,及,己,急,奇,挤,畸,棘,迹,给
耀	乐,越,悦,钥,跃,月,拗,粤,阅,岳,药,要,说	遥,约,邀,咬,谣,么,窑,哟,舀,淆,吆,姚,妖,夭,肴,腰,摇,侥
舰	健,箭,荐,剑,溅,见,件,贱,渐,键,监,践,间,建,涧,鉴	碱,肩,俭,茧,歼,艰,煎,奸,拣,减,剪,检,简,坚,兼,捡,尖,柬
藻	蚤,澡,枣,早	糟,躁,凿,造,噪,灶,燥,遭,皂
蔼	矮	挨,隘,艾,哎,埃,碍,爱,唉,哀
蘑	磨,摹,魔,摩,模,膜	墨,末,寞,默,沫,么,莫,摸,没,抹,漠,茉,脉,陌
芦	颅,庐,卢,炉	路,鲁,鹿,碌,氯,陆,卤,露,赂,录,虏
苹	屏,冯,凭,坪,平,评,萍,瓶	乒
苏	酥	肃,速,宿,俗,素,诉,溯,塑,缩,粟
蕴	运,韵,员,酝,孕,晕	匀,云,陨,耘,允
蠕	儒,软,如	乳,辱,褥,入,女
觉	窖,诀,倔,教,叫,掘,嚼,角,绝,决,校,脚,轿,较,爵	礁,蕉,搅,缴,焦,椒,骄,矫,侥,交,郊,狡,浇,剿,胶,饺,娇,绞
触	处,畜,矗	厨,橱,初,锄,础,雏,楚,出,储,除
议	掖,衣,忆,溢,肄,易,屹,一,亿,意,艺,邑,义,绎,毅,亦,译,益,逸,翼,奕,液,役,谊,艾,腋,抑,疫,异	已,乙,疑,倚,医,揖,夷,移,矣,遗,宜,尾,椅,蛇,漪,姨,壹,以,依,胰,仪,伊,蚁
譬	屁,僻,辟	坏,霹,疲,否,脾,啤,批,罢,皮,劈,被,匹,披
警	颈,景,井,阱	兢,静,晶,鲸,靖,惊,竟,精,境,更,睛,茎,径,京,劲,敬,荆,竞,净,镜,经
译	掖,衣,忆,溢,肄,易,屹,一,亿,意,艺,邑,义,绎,议,毅,亦,益,逸,翼,奕,液,役,谊,艾,腋,抑,疫,异	已,乙,疑,倚,医,揖,夷,移,矣,遗,宜,尾,椅,蛇,漪,姨,壹,以,依,胰,仪,伊,蚁
赢	萤,迎,蝇,荧,营,盈,莹	影,莺,鹰,婴,应,硬,英,缨,景,鹦,樱,映,颖
赡	善,扇,擅,膳,单	删,山,衫,珊,闪,杉,陕
躁	造,噪,灶,燥,皂	糟,凿,蚤,枣,早,藻,澡,遭
释	恃,适,誓,侍,饰,嗜,士,式,拭,事,示,室,识,市,使,世,势,是,氏,视,柿,逝,试	拾,石,提,失,射,始,虱,十,屎,尸,矢,什,驶,匙,实,史,食,师,硕,湿,蚀,狮,诗,时,施
钟	终,忠,衷,盅,中	仲,种,重,众,肿
锈	绣,臭,宿,秀,嗅,袖	休,羞,修,朽
阐	产,铲	缠,搀,馋,掺,单,蝉
飘	漂	瓢,票
饶		绕,扰
腾	誊,疼	
骚	艘,搔	嫂,扫
党	档,挡	铛,裆,当,荡
龄	铃,凌,玲,零,菱,陵,翎,蛉,伶,灵	另,岭,领,令
嚣	哮,销,萧,削,硝,宵,箫,消	小,啸,酵,校,学,肖,效,孝,笑,晓
属	鼠,薯,数,蜀,暑,煮,主,拄,嘱,署,贮,黍	柱,注,驻,烛,树,朱,赎,珠,述,梳,束,恕,竹,蔬,铸,输,疏,轴,抒,竖,书,曙,淑,墅,术,猪,庶,逐,漱,枢,蛀,熟,住,蛛,叔,诸,舒,株,殊,助,祝,筑
巍	薇,唯,违,围,为,微,桅,维,危	威,委,谓,魏,味,未,喂,遗,畏,伟,尾,胃,位,伪,偎,纬,慰,尉,萎,卫,苇,蔚
惧	拒,足,炬,俱,据,聚,锯,句,巨,具,距,剧	菊,蛆,沮,居,橘,车,鞠,矩,举,局,驹,拘
摄	社,拾,叶,设,舍,射,涉,赦	蛇,舍,什,奢,舌,甚,赊
携	希,吸,行,溪,谐,稀,牺,膝,熙,犀,西,悉,晰,协,斜,栖,胁,嬉,蟋,厘,邪,析,鞋,挟,畦	泻,息,习,楔,写,解,骇,席,卸,锡,隙,些,系,谢,媳,戏,熄,洗,喜,惜,蟹,械,屑,歇,懈,屉,昔,细,夕,徙,血,契,袭
樱	鹰,莺,应,婴,英,缨,鹦	萤,赢,影,硬,迎,蝇,荧,营,景,盈,映,莹,颖
栏	篮,澜,拦,兰,蓝	懒,烂,滥,览,榄,缆,揽
歼	肩,艰,煎,奸,渐,监,间,溅,坚,兼,尖	箭,见,拣,减,剪,建,捡,件,贱,键,践,鉴,俭,碱,舰,茧,检,简,柬,健,荐,剑,涧
灌	冠,观,罐,贯,惯	关,馆,棺,管,官
烂	缆,滥	篮,懒,览,榄,澜,拦,兰,蓝,揽,栏
牺	西,悉,希,晰,溪,厘,析,稀,栖,嬉,膝,熙,犀,吸,蟋,行,携,畦	席,息,习,昔,锡,喜,惜,细,夕,隙,系,徙,熄,媳,袭,洗,戏
癞	赖	莱,来
缠	馋,单,蝉	阐,搀,掺,产,铲
续	叙,絮,旭,绪,酗,婿,蓄,畜,恤,序	徐,吁,需,须,许,虚
兰	篮,澜,拦,蓝,栏	懒,烂,滥,览,榄,缆,揽
蠢		唇,纯,醇,淳,春
蜡	落,腊,辣	喇,拉,啦
袜		挖,娃,蛙,洼,瓦
览	榄,揽,懒,缆	篮,烂,滥,澜,拦,兰,蓝,栏
谴	遣,浅	钱,铅,千,钳,嵌,迁,黔,纤,歉,牵,谦,签,欠,干,潜,前
护	沪,户,互	糊,戏,壶,胡,许,乎,蝴,唬,葫,虎,湖,狐,呼,忽,弧
誉	狱,预,语,欲,玉,御,愈,吁,豫,喻,寓,郁,浴,域,裕,育,尉,谷,芋,与,遇	隅,羽,雨,屿,宇,愉,于,迂,鱼,愚,予,榆,逾,淤,渔,娱,舆
赃	脏	葬,脏,藏
跃	乐,越,悦,钥,月,耀,粤,阅,岳,药,说	约
轰	烘,哄	汞,鸿,宏,红,虹,洪
辩	变,便,辫,辨,遍	蝙,贬,边,编,鞭,扁,匾
镰	怜,联,廉,莲,连,帘	炼,敛,练,恋,脸,链
铁	帖	贴
铛	当,裆	党,档,挡,荡
霸	爸,坝,耙,罢,伯	捌,芭,笆,扒,拔,巴,靶,叭,八,疤,跋,吧,把
霹	坏,批,劈,被,匹,披	疲,譬,否,罢,啤,脾,皮,僻,辟,屁
露	路,鹿,碌,漏,氯,陆,陋,赂,录	卢,炉,芦,搂,娄,楼,庐,卤,颅,篓,鲁,虏
响	想,享	向,镶,箱,乡,祥,降,详,相,厢,像,巷,橡,香,湘,项,象,翔
顾	雇,告,固,故,估	滑,凸,古,沽,咕,谷,骨,孤,股,鼓,姑,家,贾,辜
驱	圈,岖,蛆,趋,区,曲,躯,屈	取,漆,渠,娶,趣,去
骡	罗,螺,萝,箩,逻,锣	洛,烙,络,裸,骆,落,酪
魔	蘑,磨,摹,摩,模,膜	墨,末,寞,默,沫,么,莫,摸,没,抹,漠,茉,脉,陌
鳍	祈,期,旗,棋,只,脐,崎,奇,其,骑,歧,畦,枝,齐	气,启,起,柒,稽,戚,弃,溪,迄,器,泣,欺,漆,砌,乞,栖,七,凄,妻,契,汽,岂,企
莺	鹰,应,婴,英,缨,鹦,樱	萤,赢,影,硬,迎,蝇,荧,营,景,盈,映,莹,颖
鹤	喝,嚎,吓,荷,壕,豪,赫,号,毫,和,贺	镐,盒,呵,耗,何,禾,核,合,浩,好,褐,盖,河,蒿
峦		卵,乱
弯	豌,湾	宛,挽,婉,碗,丸,惋,完,顽,万,腕,晚,玩,娩
摊	探,贪,滩,瘫	谈,叹,坦,昙,袒,潭,痰,坛,谭,炭,弹,檀,碳,毯
权	卷,全,拳,痊,泉,犬	圈,券,劝
欢		焕,痪,缓,幻,环,涣,还,唤,宦,患,换
洒	撒	萨,飒
滩	瘫,探,贪,摊	谈,叹,坦,昙,袒,潭,痰,坛,谭,炭,弹,檀,碳,毯
瓤	攘	让,嚷,壤
叠	蝶,谍,跌,碟	爹
瘾	隐,引,听,蚓,饮	因,姻,音,银,淫,吟,殷,印,茵,阴
癣	险,铣,鲜,显	宪,先,闲,嫌,现,限,陷,咸,线,弦,馅,腺,衔,县,献,贤,涎,掀,纤,舷,仙
笼	隆,龙,咙,窿,胧,聋	垄,拢
聋	隆,龙,咙,窿,胧,笼	垄,拢
脏	葬,藏,赃	葬,藏,赃
袭	席,息,习,锡,昔,惜,媳,熄	希,吸,行,溪,稀,隙,牺,系,膝,熙,犀,携,戏,洗,西,悉,晰,喜,栖,嬉,蟋,厘,析,细,夕,徙,畦
衬	趁,称	陈,尘,忱,晨,沈,臣,沉,辰
读	豆,牍,毒,逗,痘,斗,独	蚪,兜,抖,睹,妒,肚,渡,陡,督,斗,都,赌,度,镀,杜,堵
赎	熟,叔,淑	鼠,蜀,树,述,梳,暑,束,恕,蔬,输,黍,疏,薯,竖,抒,书,曙,属,墅,术,庶,枢,漱,数,署,舒,殊
铸	柱,蛀,注,住,驻,助,祝	轴,逐,猪,煮,蛛,主,竹,诸,属,烛,嘱,朱,拄,株,术,珠,贮,筑
鉴	舰,健,箭,荐,剑,溅,见,件,贱,渐,键,监,践,间,建,涧	碱,肩,俭,茧,歼,艰,煎,奸,拣,减,剪,检,简,坚,兼,捡,尖,柬
缰	将,浆,僵,疆,姜,江	奖,强,桨,酱,蒋,降,匠,讲
颤	占,站,战,暂,蘸,栈,绽	毡,斩,盏,展,崭,瞻,沾
骄	蕉,教,焦,椒,交,郊,礁,浇,胶,娇	窖,搅,缴,叫,觉,轿,狡,矫,嚼,角,侥,校,脚,剿,较,饺,绞
鳖		瘪,别
鸥	呕,殴,欧,区	藕,偶
恋	练,链,敛,炼	怜,脸,联,廉,莲,连,帘,镰
搅	搞,缴,狡,矫,角,稿,绞,脚,剿,较,饺,侥	窖,焦,交,篙,膏,娇,蕉,校,胶,高,叫,觉,椒,骄,嚼,郊,轿,糕,告,教,礁,浇,羔
窃	切,怯,契	茄,且
缨	鹰,莺,应,婴,英,鹦,樱	萤,赢,影,硬,迎,蝇,荧,营,景,盈,映,莹,颖
蘸	占,站,战,颤,暂,栈,绽	毡,斩,盏,展,崭,瞻,沾
萝	罗,螺,箩,骡,逻,锣	洛,烙,络,裸,骆,落,酪
变	便,辩,辫,辨,遍	蝙,贬,边,编,鞭,扁,匾
逻	罗,螺,萝,骡,箩,锣	洛,烙,络,裸,骆,落,酪
显	险,铣,癣,鲜	宪,先,闲,嫌,现,限,陷,咸,线,弦,馅,腺,衔,县,献,贤,涎,掀,纤,舷,仙
惊	精,京,兢,晶,鲸,更,睛,荆,经,茎	径,境,竞,静,劲,净,警,靖,颈,阱,景,敬,镜,井,竟
验	燕,咽,焰,艳,研,沿,谚,厌,雁,砚,淹,堰,唁,宴	延,癌,掩,阎,严,衍,烟,眼,奄,殷,演,颜,盐,炎,言
髓		随,虽,穗,碎,遂,祟,隧,岁
体		剃,堤,题,屉,提,啼,梯,踢,剔,涕,替,蹄,惕
鳞	淋,磷,邻,琳,林,临	凛,赁,吝,躏
嘱	煮,主,属,拄,贮	柱,轴,蛀,逐,注,住,蛛,驻,珠,竹,诸,烛,助,朱,铸,株,术,猪,祝,筑
坝	爸,耙,罢,霸,伯	捌,芭,笆,扒,拔,巴,靶,叭,八,疤,跋,吧,把
揽	榄,懒,览,缆	篮,烂,滥,澜,拦,兰,蓝,栏
瘫	探,贪,滩,摊	谈,叹,坦,昙,袒,潭,痰,坛,谭,炭,弹,檀,碳,毯
矗	处,畜,触	厨,橱,初,锄,础,雏,楚,出,储,除
罐	冠,观,灌,贯,惯	关,馆,棺,管,官
蚕	惭,残	灿,餐,惨,参
艳	燕,验,咽,焰,研,沿,谚,厌,雁,砚,宴,堰,唁,淹	延,癌,掩,阎,严,衍,烟,眼,奄,殷,演,颜,盐,炎,言
酿		娘
雳	利,立,粒,隶,丽,砾,力,痢,莉,厉,例,俐,吏,历,励,沥,荔,栗	哩,李,里,理,厘,璃,离,漓,篱,梨,犁,礼,狸,鲤,黎
灵	铃,凌,玲,龄,零,菱,陵,翎,蛉,伶	另,岭,领,令
骤	奏,揍	走
鬓		濒,宾,滨,彬,缤
鹰	莺,应,婴,英,缨,鹦,樱	萤,赢,影,硬,迎,蝇,荧,营,景,膺,盈,映,莹,颖
碱	茧,拣,减,剪,检,简,俭,捡,柬	箭,见,建,歼,艰,煎,件,贱,键,践,鉴,舰,肩,渐,监,间,坚,尖,健,荐,剑,奸,涧,溅,兼
盐	延,癌,阎,严,研,沿,颜,炎,言	燕,掩,眼,衍,验,烟,咽,焰,奄,艳,殷,演,厌,谚,雁,砚,淹,堰,唁,宴
厅	听	亭,蜓,庭,挺,丁,艇,停,廷
榄	揽,懒,览,缆	篮,烂,滥,澜,拦,兰,蓝,栏
湾	弯,豌	宛,挽,婉,碗,丸,惋,完,顽,万,腕,晚,玩,娩
篱	丽,璃,厘,离,漓,梨,犁,狸,黎	立,砾,痢,俐,鲤,沥,哩,隶,励,粒,李,里,厉,雳,历,荔,栗,利,力,理,莉,例,吏,礼
箩	萝,罗,螺,骡,逻,锣	洛,烙,络,裸,骆,落,酪
蛮	馒,漫,瞒	满,曼,蔓,幔,慢
观	冠,罐,关,棺,灌,贯,官,惯	馆,管
衅	信,芯	寻,薪,新,心,辛,锌,欣
镶	箱,乡,厢,相,香,湘	响,向,享,祥,想,详,像,降,橡,巷,项,象,翔
钥	乐,越,悦,跃,月,拗,耀,粤,阅,岳,药,要,说	遥,约,邀,咬,谣,么,窑,哟,舀,淆,吆,姚,妖,夭,肴,腰,摇,侥
颅	庐,卢,炉,芦	路,鲁,鹿,碌,氯,陆,卤,露,赂,录,虏
馋	缠,单,蝉	阐,搀,掺,产,铲
镊	孽,聂	捏
驴		虑,滤,缕,率,旅,铝,侣,氯,绿,吕,屡,律,履,娄
缆	懒,烂,滥,览,榄,揽	篮,澜,拦,兰,蓝,栏
躏	吝,赁	淋,磷,邻,琳,凛,鳞,林,临
钻	赚	
锣	萝,螺,罗,骡,箩,逻	洛,烙,络,裸,骆,落,酪
鳄	噩,哑,遏,俄,恶,饿,愕,扼	讹,鹅,额,蛾,阿
凿	作,做,坐,座	糟,躁,蚤,造,枣,噪,早,左,昨,灶,藻,燥,澡,遭,皂
鹦	莺,鹰,应,婴,英,缨,樱	萤,赢,影,硬,迎,蝇,荧,营,景,盈,映,莹,颖
		
是	恃,适,誓,侍,嗜,饰,士,式,事,拭,示,室,释,识,市,使,世,势,氏,视,柿,逝,试	拾,石,失,提,始,射,虱,十,屎,尸,矢,什,驶,匙,实,史,食,师,硕,湿,蚀,狮,诗,时,施
要	乐,邀,么,哟,钥,吆,拗,妖,耀,夭,腰,药	遥,咬,谣,窑,舀,淆,姚,肴,摇,侥
酯		之
你	拟	呢,匿,泥,腻,尼,溺,逆
书	抒,枢,梳,舒,蔬,殊,输,疏	鼠,蜀,树,赎,述,暑,束,恕,黍,薯,竖,曙,淑,属,墅,术,庶,漱,数,熟,叔,署
这	蔗,宅,浙	着,遮,摘,哲,者,辙
我		涡,卧,窝,沃,握
怎		贼,则,择,泽,窄,责,侧
外		舀,歪
塌	蹋,踏	塔
让		攘,瓤,嚷,壤
膺		鹰
